"a" = (/turf/simulated/floor/plating/planet/jungle/templatethick,/area/jungle)
"b" = (/obj/item/weapon/storage/secure/briefcase/money,/obj/item/remains/human,/turf/simulated/floor/plating/planet/jungle/path,/area/jungle)
"c" = (/obj/effect/decal/cleanable/blood/drip,/turf/simulated/floor/plating/planet/jungle/path,/area/jungle)
"d" = (/turf/simulated/floor/plating/planet/jungle/path,/area/jungle)
"e" = (/turf/simulated/floor/plating/planet/jungle/clear/dark,/area/jungle)
"f" = (/obj/structure/closet/crate/secure/loot,/turf/simulated/floor/plating/planet/jungle/path,/area/jungle)
"g" = (/obj/item/remains/robot,/turf/simulated/floor/plating/planet/jungle/path,/area/jungle)
"h" = (/obj/structure/shuttle/engine/propulsion/burst{dir = 4},/turf/simulated/floor/plating/planet/jungle/clear/dark,/area/jungle)
"i" = (/obj/effect/decal/cleanable/blood/drip,/turf/simulated/floor/plating/planet/jungle/clear/dark,/area/jungle)
"j" = (/obj/effect/decal/cleanable/ash,/turf/simulated/floor/plating,/area/jungle)
"k" = (/turf/simulated/floor/plating,/area/jungle)
"l" = (/turf/simulated/shuttle/wall{tag = "icon-swall_straight (EAST)"; icon_state = "swall_straight"; dir = 4},/area/jungle)
"m" = (/turf/simulated/floor/plating/planet/jungle,/turf/simulated/shuttle/wall{tag = "icon-corner_white"; icon_state = "corner_white"},/area/jungle)
"n" = (/obj/item/remains/robot,/turf/simulated/floor/plating/planet/jungle/clear/dark,/area/jungle)
"o" = (/obj/machinery/door/airlock/external{aiControlDisabled = 1; aiDisabledIdScanner = 1; autoclose = 0; density = 0; explosion_resistance = 0; frequency = null; icon_state = "door_open"; id_tag = null; locked = 1; main_power_lost_until = -1; name = "Escape Pod Hatch"; opacity = 0},/obj/effect/decal/cleanable/dirt,/obj/effect/decal/cleanable/blood/drip,/turf/simulated/floor/plating,/area/jungle)
"p" = (/obj/effect/decal/cleanable/dirt,/turf/simulated/floor/plating,/area/jungle)
"q" = (/obj/structure/bed/chair/urist/shuttle{tag = "icon-shuttlechair (EAST)"; icon_state = "shuttlechair"; dir = 4},/obj/machinery/light/small{active_power_usage = 10; brightness_range = 5; dir = 4; icon_state = "bulb-broken"; status = 2},/obj/effect/decal/cleanable/dirt,/obj/item/weapon/material/shard{icon_state = "medium"},/obj/effect/decal/cleanable/cobweb2,/turf/simulated/shuttle/floor,/area/jungle)
"r" = (/obj/structure/window/reinforced,/obj/item/stack/rods,/obj/item/stack/rods,/obj/item/stack/rods,/obj/item/weapon/material/shard,/obj/item/weapon/material/shard{icon_state = "small"},/turf/simulated/floor/plating,/area/jungle)
"s" = (/obj/structure/bed/chair/urist/shuttle,/turf/simulated/floor/plating/planet/jungle/clear/dark,/area/jungle)
"t" = (/turf/simulated/floor/plating,/obj/structure/shuttle/engine/propulsion/burst{dir = 4},/turf/simulated/shuttle/wall{icon_state = "swall_f5"; dir = 2},/area/jungle)
"u" = (/turf/simulated/floor/plating/planet/jungle,/turf/simulated/shuttle/wall{tag = "icon-corner_white (SOUTHEAST)"; icon_state = "corner_white"; dir = 6},/area/jungle)

(1,1,1) = {"
aaaaaaaaaaaaaaaaaaaaaaaaa
aaaaaaaaaaaaaaaaaabaaaaaa
aaaaaaaaaaaaaaaaaaacaaaaa
aaaaaaaaaaaaaaaaaadaaaaaa
aaaaaaaaaaaaaaaaaadaaaaaa
aaaaaaaaaaaaaaaaaaacaaaaa
aaaaaaaaaaaaaaaaaaadaaaaa
aaaaaaaaaaaaaaaaaacaaaaaa
aaaaaaaaaaaaaaaaaaddaaaaa
adaedfagdeheeedeaedidjklm
dagddeddddeefnddededdopqr
aadedadededdadesdednetllu
"}
