"a" = (/turf/simulated/floor/plating/planet/jungle/templatethick,/area/jungle)
"b" = (/turf/simulated/floor/plating/planet/jungle/rock,/area/jungle)
"c" = (/turf/simulated/floor/plating/planet/jungle/clear/underground,/area/jungle)
"d" = (/obj/effect/spider,/turf/simulated/floor/plating/planet/jungle/clear/underground,/area/jungle)
"e" = (/obj/effect/decal/cleanable/dirt,/turf/simulated/floor/plating/planet/jungle/clear/underground,/area/jungle)
"f" = (/obj/random/loot,/obj/structure/closet/crate,/obj/random/maintenance/clean,/obj/random/maintenance/clean,/turf/simulated/floor/plating/planet/jungle/clear/underground,/area/jungle)
"g" = (/obj/effect/spider,/obj/effect/decal/cleanable/cobweb,/obj/effect/decal/cleanable/dirt,/turf/simulated/floor/plating/planet/jungle/clear/underground,/area/jungle)

(1,1,1) = {"
aaaaaaabbbbaaaa
aaaaabbbbbbbaaa
aaabbbbccccbbba
aabbbbccccccbbb
aabbcccccccccbb
abbdccccbccccbb
abcccccbbbcccbb
abcbbcbbbccccbb
abcebbbbccccbba
abbeeebbbfcbbaa
aabbbebbbbbbaaa
aaabbgbbbbbaaaa
aaaaaaaaaaaaaaa
"}
