"aa" = (/turf/space,/area/space)
"ab" = (/turf/unsimulated/wall/urist/other{tag = "icon-1,0 (NORTH)"; icon_state = "1,0"; dir = 1},/area/boarding_ship)
"ac" = (/turf/unsimulated/wall/urist/other{tag = "icon-1,0 (SOUTHEAST)"; icon_state = "1,0"; dir = 6},/area/boarding_ship)
"ad" = (/turf/unsimulated/wall/urist/other{tag = "icon-1,0 (SOUTHEAST)"; icon_state = "1,0"; dir = 6},/turf/unsimulated/wall/urist/other{tag = "icon-9,15 (SOUTHEAST)"; icon_state = "9,15"; dir = 6},/area/boarding_ship)
"ae" = (/turf/unsimulated/wall/urist/other{tag = "icon-1,0 (EAST)"; icon_state = "1,0"; dir = 4},/area/boarding_ship)
"af" = (/turf/unsimulated/wall/urist/other{tag = "icon-1,0 (NORTHWEST)"; icon_state = "1,0"; dir = 9},/area/boarding_ship)
"ag" = (/turf/unsimulated/floor/uristturf/other/scom{tag = "icon-5,1"; icon_state = "5,1"},/turf/unsimulated/wall/urist/other/see{tag = "icon-8,15"; icon_state = "8,15"},/area/boarding_ship)
"ah" = (/turf/unsimulated/floor/uristturf/other/scom{tag = "icon-5,1"; icon_state = "5,1"},/area/boarding_ship)
"ai" = (/turf/unsimulated/floor/uristturf/other/scom{tag = "icon-9,7"; icon_state = "9,7"},/area/boarding_ship)
"aj" = (/turf/unsimulated/floor/uristturf/other/scom{tag = "icon-5,1"; icon_state = "5,1"},/turf/unsimulated/wall/urist/other/see{tag = "icon-8,15 (NORTH)"; icon_state = "8,15"; dir = 1},/area/boarding_ship)
"ak" = (/turf/unsimulated/wall/urist/other{tag = "icon-1,0 (SOUTHWEST)"; icon_state = "1,0"; dir = 10},/area/boarding_ship)
"al" = (/turf/unsimulated/floor/uristturf/other/scom{tag = "icon-5,1"; icon_state = "5,1"},/turf/unsimulated/wall/urist/other/see{tag = "icon-8,14"; icon_state = "8,14"},/area/boarding_ship)
"am" = (/obj/effect/urist/triggers/ai_defender_landmark/lactera/leader,/turf/unsimulated/floor/uristturf/other/scom{tag = "icon-9,7"; icon_state = "9,7"},/area/boarding_ship)
"an" = (/turf/unsimulated/floor/uristturf/other/scom{tag = "icon-5,1"; icon_state = "5,1"},/turf/unsimulated/wall/urist/other/see{tag = "icon-8,14 (NORTH)"; icon_state = "8,14"; dir = 1},/area/boarding_ship)
"ao" = (/obj/effect/urist/triggers/defender_landmark/lactera,/turf/unsimulated/floor/uristturf/other/scom{tag = "icon-9,7"; icon_state = "9,7"},/area/boarding_ship)
"ap" = (/turf/unsimulated/wall/urist/other{tag = "icon-1,0"; icon_state = "1,0"; dir = 2},/area/boarding_ship)
"aq" = (/turf/unsimulated/wall/urist/other{tag = "icon-1,0.1.1.1.1.1.1.1.1 (NORTH)"; icon_state = "1,0.1.1.1.1.1.1.1.1"; dir = 1},/area/boarding_ship)
"ar" = (/turf/unsimulated/wall/urist/other{tag = "icon-1,0 (WEST)"; icon_state = "1,0"; dir = 8},/area/boarding_ship)
"as" = (/turf/unsimulated/wall/urist/other{tag = "icon-3,15 (NORTHWEST)"; icon_state = "3,15"; dir = 9},/area/boarding_ship)
"at" = (/turf/unsimulated/wall/urist/other{tag = "icon-3,15"; icon_state = "3,15"; dir = 2},/area/boarding_ship)
"au" = (/turf/unsimulated/wall/urist/other{tag = "icon-3,15"; icon_state = "3,15"; dir = 2},/turf/unsimulated/wall/urist/other{tag = "icon-9,15 (SOUTHEAST)"; icon_state = "9,15"; dir = 6},/area/boarding_ship)
"av" = (/turf/unsimulated/wall/urist/other{tag = "icon-3,15 (SOUTHEAST)"; icon_state = "3,15"; dir = 6},/area/boarding_ship)
"aw" = (/turf/unsimulated/wall/urist/other{tag = "icon-3,15 (WEST)"; icon_state = "3,15"; dir = 8},/area/boarding_ship)
"ax" = (/turf/unsimulated/floor/uristturf/other/scom{tag = "icon-2,1"; icon_state = "2,1"},/turf/unsimulated/wall/urist/other/see{tag = "icon-8,15"; icon_state = "8,15"},/area/boarding_ship)
"ay" = (/turf/unsimulated/floor/uristturf/other/scom{tag = "icon-1,1"; icon_state = "1,1"},/area/boarding_ship)
"az" = (/turf/unsimulated/floor/uristturf/other/scom{tag = "icon-2,1"; icon_state = "2,1"},/turf/unsimulated/wall/urist/other/see{tag = "icon-8,15 (NORTH)"; icon_state = "8,15"; dir = 1},/area/boarding_ship)
"aA" = (/obj/effect/urist/triggers/ai_defender_landmark/lactera/heavy,/turf/unsimulated/floor/uristturf/other/scom{tag = "icon-5,1"; icon_state = "5,1"},/area/boarding_ship)
"aB" = (/obj/effect/urist/triggers/ai_defender_landmark/lactera,/turf/unsimulated/floor/uristturf/other/scom{tag = "icon-5,1"; icon_state = "5,1"},/area/boarding_ship)
"aC" = (/turf/unsimulated/wall/urist/other{tag = "icon-3,15 (EAST)"; icon_state = "3,15"; dir = 4},/area/boarding_ship)
"aD" = (/turf/unsimulated/floor/uristturf/other/scom{tag = "icon-2,1"; icon_state = "2,1"},/turf/unsimulated/wall/urist/other/see{tag = "icon-8,14"; icon_state = "8,14"},/area/boarding_ship)
"aE" = (/turf/unsimulated/floor/uristturf/other/scom{tag = "icon-2,1"; icon_state = "2,1"},/area/boarding_ship)
"aF" = (/turf/unsimulated/floor/uristturf/other/scom{tag = "icon-2,1"; icon_state = "2,1"},/turf/unsimulated/wall/urist/other/see{tag = "icon-8,14 (NORTH)"; icon_state = "8,14"; dir = 1},/area/boarding_ship)
"aG" = (/turf/unsimulated/wall/urist/other{tag = "icon-3,15 (NORTHEAST)"; icon_state = "3,15"; dir = 5},/area/boarding_ship)
"aH" = (/obj/effect/urist/triggers/ai_defender_landmark/lactera,/turf/unsimulated/floor/uristturf/other/scom{tag = "icon-1,1"; icon_state = "1,1"},/area/boarding_ship)
"aI" = (/turf/unsimulated/wall/urist/other{tag = "icon-3,15 (SOUTHWEST)"; icon_state = "3,15"; dir = 10},/area/boarding_ship)
"aJ" = (/turf/unsimulated/wall/urist/other{tag = "icon-1,0 (NORTHEAST)"; icon_state = "1,0"; dir = 5},/area/boarding_ship)
"aK" = (/turf/unsimulated/floor/uristturf/other/scom{tag = "icon-2,14 (SOUTHEAST)"; icon_state = "2,14"; dir = 6},/area/boarding_ship)
"aL" = (/turf/unsimulated/wall/urist/other/destructable{tag = "icon-3,15"; icon_state = "3,15"; dir = 2},/area/boarding_ship)
"aM" = (/turf/unsimulated/floor/uristturf/other/scom/destructable{tag = "icon-3,1"; icon_state = "3,1"},/area/boarding_ship)
"aN" = (/turf/unsimulated/floor/uristturf/other/scom{tag = "icon-2,14"; icon_state = "2,14"},/area/boarding_ship)
"aO" = (/turf/unsimulated/floor/uristturf/other/scom{tag = "icon-2,14 (NORTH)"; icon_state = "2,14"; dir = 1},/area/boarding_ship)
"aP" = (/turf/unsimulated/wall/urist/other/see{tag = "icon-0,14"; icon_state = "0,14"},/area/boarding_ship)
"aQ" = (/turf/unsimulated/floor/uristturf/other/scom{tag = "icon-0,15"; icon_state = "0,15"},/area/boarding_ship)
"aR" = (/turf/unsimulated/floor/uristturf/other/scom{tag = "icon-0,15.1"; icon_state = "0,15.1"},/area/boarding_ship)
"aS" = (/turf/unsimulated/floor/uristturf/other/scom{tag = "icon-1,15"; icon_state = "1,15"},/area/boarding_ship)
"aT" = (/turf/unsimulated/wall/urist/other/see{tag = "icon-1,14"; icon_state = "1,14"},/area/boarding_ship)
"aU" = (/turf/unsimulated/wall/urist/other{tag = "icon-5,14"; icon_state = "5,14"},/area/boarding_ship)
"aV" = (/turf/unsimulated/wall/urist/other{tag = "icon-4,14"; icon_state = "4,14"},/area/boarding_ship)
"aW" = (/turf/unsimulated/wall/urist/other/see{tag = "icon-2,12"; icon_state = "2,12"},/area/boarding_ship)
"aX" = (/turf/unsimulated/wall/urist/other/see{tag = "icon-0,11"; icon_state = "0,11"},/area/boarding_ship)
"aY" = (/turf/unsimulated/wall/urist/other/see{tag = "icon-1,10"; icon_state = "1,10"},/area/boarding_ship)
"aZ" = (/turf/unsimulated/wall/urist/other/see{tag = "icon-0,10"; icon_state = "0,10"},/area/boarding_ship)
"ba" = (/obj/effect/urist/triggers/ai_defender_landmark/lactera,/turf/unsimulated/floor/uristturf/other/scom{tag = "icon-0,15.1"; icon_state = "0,15.1"},/area/boarding_ship)
"bb" = (/obj/effect/urist/triggers/ai_defender_landmark/lactera,/turf/unsimulated/floor/uristturf/other/scom{tag = "icon-9,7"; icon_state = "9,7"},/area/boarding_ship)
"bc" = (/obj/effect/template_loader/ships,/turf/unsimulated/wall/urist/other/see{tag = "icon-2,12"; icon_state = "2,12"},/area/boarding_ship)
"bd" = (/turf/unsimulated/floor/uristturf/other/scom{tag = "icon-3,1"; icon_state = "3,1"},/area/boarding_ship)
"be" = (/obj/effect/urist/triggers/ai_defender_landmark/lactera,/turf/unsimulated/floor/uristturf/other/scom{tag = "icon-1,15"; icon_state = "1,15"},/area/boarding_ship)
"bf" = (/turf/unsimulated/wall/urist/other/see{tag = "icon-1,14"; icon_state = "1,14"},/turf/unsimulated/wall/urist/other/see{tag = "icon-6,14 (EAST)"; icon_state = "6,14"; dir = 4},/area/boarding_ship)
"bg" = (/turf/unsimulated/wall/urist/other/see{tag = "icon-2,12"; icon_state = "2,12"},/turf/unsimulated/wall/urist/other/see{tag = "icon-6,14 (EAST)"; icon_state = "6,14"; dir = 4},/area/boarding_ship)
"bh" = (/turf/unsimulated/wall/urist/other{tag = "icon-3,0"; icon_state = "3,0"},/turf/unsimulated/wall/urist/other/see{tag = "icon-6,14 (EAST)"; icon_state = "6,14"; dir = 4},/area/boarding_ship)
"bi" = (/turf/unsimulated/wall/urist/other/see{tag = "icon-0,11"; icon_state = "0,11"},/turf/unsimulated/wall/urist/other/see{tag = "icon-6,14 (EAST)"; icon_state = "6,14"; dir = 4},/area/boarding_ship)
"bj" = (/turf/unsimulated/wall/urist/other/see{tag = "icon-0,14"; icon_state = "0,14"},/turf/unsimulated/wall/urist/other/see{tag = "icon-6,14 (EAST)"; icon_state = "6,14"; dir = 4},/area/boarding_ship)
"bk" = (/turf/unsimulated/wall/urist/other{tag = "icon-3,0"; icon_state = "3,0"},/area/boarding_ship)
"bl" = (/turf/unsimulated/wall/urist/other/see{tag = "icon-3,0"; icon_state = "3,0"},/area/boarding_ship)
"bm" = (/turf/unsimulated/wall/urist/other{tag = "icon-123456 (WEST)"; icon_state = "123456"; dir = 8},/area/boarding_ship)
"bn" = (/turf/unsimulated/wall/urist/other{tag = "icon-3,15 (NORTH)"; icon_state = "3,15"; dir = 1},/area/boarding_ship)
"bo" = (/obj/structure/scom/science{icon_state = "2,11"; scommoney = 300; tag = "icon-2,11"},/turf/unsimulated/wall/urist/other/see{tag = "icon-2,11"; icon_state = "2,11"},/area/boarding_ship)
"bp" = (/turf/unsimulated/floor/uristturf/other/scom{tag = "icon-0,13"; icon_state = "0,13"},/area/boarding_ship)
"bq" = (/turf/unsimulated/floor/uristturf/other/scom{tag = "icon-1,13"; icon_state = "1,13"},/area/boarding_ship)
"br" = (/obj/structure/scom/science{icon_state = "0,12"; scommoney = 300; tag = "icon-0,12"},/turf/unsimulated/wall/urist/other/see{tag = "icon-0,12"; icon_state = "0,12"},/area/boarding_ship)
"bs" = (/turf/unsimulated/wall/urist/other/see{tag = "icon-2,13"; icon_state = "2,13"},/area/boarding_ship)
"bt" = (/turf/unsimulated/wall/urist/other/see{tag = "icon-3,13"; icon_state = "3,13"},/area/boarding_ship)
"bu" = (/obj/effect/urist/triggers/ai_defender_landmark/lactera,/turf/unsimulated/floor/uristturf/other/scom{tag = "icon-1,15"; icon_state = "1,15"},/area/boarding_ship)
"bv" = (/obj/effect/urist/triggers/ai_defender_landmark/lactera,/turf/unsimulated/floor/uristturf/other/scom{tag = "icon-0,15"; icon_state = "0,15"},/area/boarding_ship)
"bw" = (/obj/structure/boarding/shipportal,/obj/effect/urist/triggers/boarding_landmark,/turf/unsimulated/floor/uristturf/other/scom{tag = "icon-0,15.1"; icon_state = "0,15.1"},/area/boarding_ship)

(1,1,1) = {"
aaaaaaaaaaaaaaaaaaaaaaaaaaaaaaaaaaaaaaaaaaaaaaaaaaaaaaaaaaaaaaaaaaaaaaaaaaaaaaaaaaaaaaaaaaaaaaaaaaaaaaaaaaaaaaaaaaaaaaaaaa
aaaaaaaaaaaaaaaaaaaaaaaaaaaaaaaaaaaaaaaaaaaaaaaaaaaaaaaaaaaaaaaaaaaaaaaaaaaaaaaaaaaaaaaaaaaaaaaaaaaaaaaaaaaaaaaaaaaaaaaaaa
aaaaaaaaaaaaaaaaaaaaaaaaaaaaaaaaaaaaaaaaaaaaaaaaaaaaaaaaaaaaaaaaaaaaaaaaaaaaaaaaaaaaaaaaaaaaaaaaaaaaaaaaaaaaaaaaaaaaaaaaaa
aaaaaaaaaaaaaaaaaaaaaaaaaaaaaaaaaaaaaaaaaaaaaaaaaaaaaaaaaaaaaaaaaaaaaaaaaaaaaaaaaaaaaaaaaaaaaaaaaaaaaaaaaaaaaaaaaaaaaaaaaa
aaaaaaaaaaaaaaaaaaaaaaaaaaaaaaaaaaaaaaaaaaaaaaaaaaaaaaaaaaaaaaaaaaaaaaaaaaaaaaaaaaaaaaaaaaaaaaaaaaaaaaaaaaaaaaaaaaaaaaaaaa
aaaaaaaaaaaaaaaaaaaaaaaaaaaaaaaaaaaaaaaaaaaaaaaaaaaaaaaaaaaaaaaaaaaaaaaaaaaaaaaaaaaaaaaaaaaaaaaaaaaaaaaaaaaaaaaaaaaaaaaaaa
aaaaaaaaaaaaaaaaaaaaaaaaaaaaaaaaaaaaaaaaaaaaaaaaaaaaabacacadadacacaeaaaaaaaaaaaaaaaaaaaaaaaaaaaaaaaaaaaaaaaaaaaaaaaaaaaaaa
aaaaaaaaaaaaaaaaaaaaaaaaaaaaaaaaaaaaaaaaaaaaaaaaaaaaafagahaiaiahajakaaaaaaaaaaaaaaaaaaaaaaaaaaaaaaaaaaaaaaaaaaaaaaaaaaaaaa
aaaaaaaaaaaaaaaaaaaaaaaaaaaaaaaaaaaaaaaaaaaaaaaaaaaaafalahaiamahanakaaaaaaaaaaaaaaaaaaaaaaaaaaaaaaaaaaaaaaaaaaaaaaaaaaaaaa
aaaaaaaaaaaaaaaaaaaaaaaaaaaaaaaaaaaaaaaaaaaaaaaaaaaaafagahaiaiahajakaaaaaaaaaaaaaaaaaaaaaaaaaaaaaaaaaaaaaaaaaaaaaaaaaaaaaa
aaaaaaaaaaaaaaaaaaaaaaaaaaaaaaaaaaaaaaaaaaaaaaaaaaaaafalahaoaiahanakaaaaaaaaaaaaaaaaaaaaaaaaaaaaaaaaaaaaaaaaaaaaaaaaaaaaaa
aaaaaaaaaaaaaaaaaaaaaaaaaaaaaaaaaaaaaaaaaaaaaaaaaaaaapaqahaiaiahaqaraaaaaaaaaaaaaaaaaaaaaaaaaaaaaaaaaaaaaaaaaaaaaaaaaaaaaa
aaaaaaaaaaaaaaaaaaaaaaaaaaaaaaaaaaaaaaaaaaaaasatauatavafahaiaiahakasatauatavaaaaaaaaaaaaaaaaaaaaaaaaaaaaaaaaaaaaaaaaaaaaaa
aaaaaaaaaaaaaaaaaaaaaaaaaaaaaaaaaaaaaaaaaaaaawaxayazawafaAaiaiaBakawaxayazawaaaaaaaaaaaaaaaaaaaaaaaaaaaaaaaaaaaaaaaaaaaaaa
aaaaaaaaaaaaaaaaaaaaaaaaaaaaaaaaaaaaaaaaaaaaaCaDaEaFawafahaiaiahakaCaDaEaFawaaaaaaaaaaaaaaaaaaaaaaaaaaaaaaaaaaaaaaaaaaaaaa
aaaaaaaaaaaaaaaaaaaaaaaaaaaaaaaaaaaaaaaaaaaaaGaEaHaEaIafahaJaJahakaGaEaHaEaIaaaaaaaaaaaaaaaaaaaaaaaaaaaaaaaaaaaaaaaaaaaaaa
aaaaaaaaaaaaaaaaaaaaaaaaaaaaaaaaaaaaaaaaaaasataKaKaKaLavaMasavaMasaLaNaKaOatavaaaaaaaaaaaaaaaaaaaaaaaaaaaaaaaaaaaaaaaaaaaa
aaaaaaaaaaaaaaaaaaaaaaaaaaaaaaaaaaaaaaaaaaaCaPaQaRaSaTawahaCawahaCaPaQaRaSaTawaaaaaaaaaaaaaaaaaaaaaaaaaaaaaaaaaaaaaaaaaaaa
aaaaaaaaaaaaaaaaaaaaaaaaaaaaaaaaaaaaaaaaaaaCaPaQaRaSaTawahaCawahaCaPaQaRaSaTawaaaaaaaaaaaaaaaaaaaaaaaaaaaaaaaaaaaaaaaaaaaa
aaaaaaaaaaaaaaaaaaaaaaaaaaaaaaaaaaaaaaaaaaaCaPaQaRaSaTaUahaVaUahaVaPaQaRaSaTawaaaaaaaaaaaaaaaaaaaaaaaaaaaaaaaaaaaaaaaaaaaa
aaaaaaaaaaaaaaaaaaaaaaaaaaaaaaaaaaaaaaaaaaaCaPaQaRaSaTaWaiaXaWaiaXaPaQaRaSaTawaaaaaaaaaaaaaaaaaaaaaaaaaaaaaaaaaaaaaaaaaaaa
aaaaaaaaaaaaaaaaaaaaaaaaaaaaaaaaaaaaaaaaaaaCaPaQaRaSaTaWaiaXaWaiaXaPaQaRaSaTawaaaaaaaaaaaaaaaaaaaaaaaaaaaaaaaaaaaaaaaaaaaa
aaaaaaaaaaaaaaaaaaaaaaaaaaaaaaaaaaaaaaaaaaaCaPaQaRaSaTaWaiaXaWaiaXaPaQaRaSaTawaaaaaaaaaaaaaaaaaaaaaaaaaaaaaaaaaaaaaaaaaaaa
aaaaaaaaaaaaaaaaaaaaaaaaaaaaaaaaaaaaaaaaaaaCaPaQaRaSaTaYaiaXaWaiaZaPaQaRaSaTawaaaaaaaaaaaaaaaaaaaaaaaaaaaaaaaaaaaaaaaaaaaa
aaaaaaaaaaaaaaaaaaaaaaaaaaaaaaaaaaaaaaaaaaaCaPaQaRaSaTaWaiaXaWaiaXaPaQaRaSaTawaaaaaaaaaaaaaaaaaaaaaaaaaaaaaaaaaaaaaaaaaaaa
aaaaaaaaaaaaaaaaaaaaaaaaaaaaaaaaaaaaaaaaaaaCaPaQaRaSaTaWaiaXaWaiaXaPaQbaaSaTawaaaaaaaaaaaaaaaaaaaaaaaaaaaaaaaaaaaaaaaaaaaa
aaaaaaaaaaaaaaaaaaaaaaaaaaaaaaaaaaaaaaaaaaaCaPaQaRaSaTaWaiaXaWaiaXaPaQaRaSaTawaaaaaaaaaaaaaaaaaaaaaaaaaaaaaaaaaaaaaaaaaaaa
aaaaaaaaaaaaaaaaaaaaaaaaaaaaaaaaaaaaaaaaaaaCaPaQaRaSaTaYbbaXaWaiaZaPaQaRaSaTawaaaaaaaaaaaaaaaaaaaaaaaaaaaaaaaaaaaaaaaaaaaa
aaaaaaaaaaaaaaaaaaaaaaaaaaaaaaaaaaaaaaaaaaaCaPaQaRaSaTaWaiaXaWaiaXaPaQaRaSaTawaaaaaaaaaaaaaaaaaaaaaaaaaaaaaaaaaaaaaaaaaaaa
aaaaaaaaaaaaaaaaaaaaaaaaaaaaaaaaaaaaaaaaaaaCaPaQaRaSaTaWaiaXaWaiaXaPaQaRaSaTawaaaaaaaaaaaaaaaaaaaaaaaaaaaaaaaaaaaaaaaaaaaa
aaaaaaaaaaaaaaaaaaaaaaaaaaaaaaaaaaaaaaaaaaaCaPaQbaaSaTaWaiaXbcaiaXaPaQaRaSaTawaaaaaaaaaaaaaaaaaaaaaaaaaaaaaaaaaaaaaaaaaaaa
aaaaaaaaaaaaaaaaaaaaaaaaaaaaaaaaaaaaaaaaaaaCaPaQaRaSaTaYaiaXaWaiaZaPaQaRaSaTawaaaaaaaaaaaaaaaaaaaaaaaaaaaaaaaaaaaaaaaaaaaa
aaaaaaaaaaaaaaaaaaaaaaaaaaaaaaaaaaaaaaaaaaaCaPaQaRaSaTaWaiaXaWaiaXaPaQaRaSaTawaaaaaaaaaaaaaaaaaaaaaaaaaaaaaaaaaaaaaaaaaaaa
aaaaaaaaaaaaaaaaaaaaaaaaaaaaaaaaaaaaaaaaaaaCaPaQaRaSaTaWaiaXaWaiaXaPaQaRaSaTawaaaaaaaaaaaaaaaaaaaaaaaaaaaaaaaaaaaaaaaaaaaa
aaaaaaaaaaaaaaaaaaaaaaaaaaaaaaaaaaaaaaaaaaaCaPaQaRaSaTaWaiaXaWaiaXaPaQaRaSaTawaaaaaaaaaaaaaaaaaaaaaaaaaaaaaaaaaaaaaaaaaaaa
aaaaaaaaaaaaaaaaaaaaaaaaaaaaaaaaaaaaaaaaaaaCaPaQaRaSaTaYaiaXaWaiaZaPaQaRaSaTawaaaaaaaaaaaaaaaaaaaaaaaaaaaaaaaaaaaaaaaaaaaa
aaaaaaaaaaaaaaaaaaaaaaaaaaaaaaaaaaaaaaaaaaaCaPaQaRaSaTaWbdaXaWbdaXaPaQaRaSaTawaaaaaaaaaaaaaaaaaaaaaaaaaaaaaaaaaaaaaaaaaaaa
aaaaaaaaaaaaaaaaaaaaaaaaaaaaaaaaaaaaaaaaaaaCaPaQaRaRaRaRaRaRaRaRaRaRaRaRaSaTawaaaaaaaaaaaaaaaaaaaaaaaaaaaaaaaaaaaaaaaaaaaa
aaaaaaaaaaaaaaaaaaaaaaaaaaaaaaaaaaaaaaaaaaaCaPaQaRaRaRaRaRaRaRaRaRaRaRaRbeaTawaaaaaaaaaaaaaaaaaaaaaaaaaaaaaaaaaaaaaaaaaaaa
aaaaaaaaaaaaaaaaaaaaaaaaaaaaaaaaaaaaaaaaaaaCaPaQaRaSbfbgbhbibgbhbibjaQaRaSaTawaaaaaaaaaaaaaaaaaaaaaaaaaaaaaaaaaaaaaaaaaaaa
aaaaaaaaaaaaaaaaaaaaaaaaaaaaaaaaaaaaaaaaaaaCaPaQaRaSaTaWbkaXaWblaXaPaQaRaSaTawaaaaaaaaaaaaaaaaaaaaaaaaaaaaaaaaaaaaaaaaaaaa
aaaaaaaaaaaaaaaaaaaaaaaaaaaaaaaaaaaaaaaaaaaCaPaQaRaSaTaWbkaXaWblaXaPaQaRaSaTawaaaaaaaaaaaaaaaaaaaaaaaaaaaaaaaaaaaaaaaaaaaa
aaaaaaaaaaaaaaaaaaaaaaaaaaaaaaaaaaaaaaaaaaaGbmaQaRaSbmbnbnbnbnbnbnbmaQaRaSbmaIaaaaaaaaaaaaaaaaaaaaaaaaaaaaaaaaaaaaaaaaaaaa
aaaaaaaaaaaaaaaaaaaaaaaaaaaaaaaaaaaaaaaaaaaaaCaNaKaOawaaaaaaaaaaaaaCaNaKaOawaaaaaaaaaaaaaaaaaaaaaaaaaaaaaaaaaaaaaaaaaaaaaa
aaaaaaaaaaaaaaaaaaaaaaaaaaaaaaaaaaaaaaaaaaaaaCaNaKaOawaaaaaaaaaaaaaCaNaKaOawaaaaaaaaaaaaaaaaaaaaaaaaaaaaaaaaaaaaaaaaaaaaaa
aaaaaaaaaaaaaaaaaaaaaaaaaaaaaaaaaaaaaaaaasatbmaQaRaSbmatavaaaaasatbmaQaRaSbmatavaaaaaaaaaaaaaaaaaaaaaaaaaaaaaaaaaaaaaaaaaa
aaaaaaaaaaaaaaaaaaaaaaaaaaaaaaaaaaaaaaaaaCaVaPaQaRaSaTaUawaaaaaCaVaPaQaRaSaTaUawaaaaaaaaaaaaaaaaaaaaaaaaaaaaaaaaaaaaaaaaaa
aaaaaaaaaaaaaaaaaaaaaaaaaaaaaaaaaaaaaaaaaCbobpaQaRaSbqbrawaaaaaCbobpaQaRaSbqbrawaaaaaaaaaaaaaaaaaaaaaaaaaaaaaaaaaaaaaaaaaa
aaaaaaaaaaaaaaaaaaaaaaaaaaaaaaaaaaaaaaaaaCaXbsaQaRaSbtaYawaaaaaCaXbsaQaRaSbtaYawaaaaaaaaaaaaaaaaaaaaaaaaaaaaaaaaaaaaaaaaaa
aaaaaaaaaaaaaaaaaaaaaaaaaaaaaaaaaaaaaaaaaCbobpaQaRaSbqbrawaaaaaCbobpaQaRaSbqbrawaaaaaaaaaaaaaaaaaaaaaaaaaaaaaaaaaaaaaaaaaa
aaaaaaaaaaaaaaaaaaaaaaaaaaaaaaaaaaaaaaaaaCaXbsaQaRaSbtaYawaaaaaCaXbsaQaRaSbtaYawaaaaaaaaaaaaaaaaaaaaaaaaaaaaaaaaaaaaaaaaaa
aaaaaaaaaaaaaaaaaaaaaaaaaaaaaaaaaaaaaaaaaCbobpaQaRaSbqbrawaaaaaCbobpaQaRaSbqbrawaaaaaaaaaaaaaaaaaaaaaaaaaaaaaaaaaaaaaaaaaa
aaaaaaaaaaaaaaaaaaaaaaaaaaaaaaaaaaaaaaaaaCaXbsaQaRaSbtaYawaaaaaCaXbsaQaRaSbtaYawaaaaaaaaaaaaaaaaaaaaaaaaaaaaaaaaaaaaaaaaaa
aaaaaaaaaaaaaaaaaaaaaaaaaaaaaaaaaaaaaaaaaCbobpaQaRaSbqbrawaaaaaCbobpaQaRaSbqbrawaaaaaaaaaaaaaaaaaaaaaaaaaaaaaaaaaaaaaaaaaa
aaaaaaaaaaaaaaaaaaaaaaaaaaaaaaaaaaaaaaaaaCaXbsaQaRbubtaYawaaaaaCaXbsaQbaaSbtaYawaaaaaaaaaaaaaaaaaaaaaaaaaaaaaaaaaaaaaaaaaa
aaaaaaaaaaaaaaaaaaaaaaaaaaaaaaaaaaaaaaaaaCbobpbvaRaSbqbrawaaaaaCbobpaQaRaSbqbrawaaaaaaaaaaaaaaaaaaaaaaaaaaaaaaaaaaaaaaaaaa
aaaaaaaaaaaaaaaaaaaaaaaaaaaaaaaaaaaaaaaaaCaXbsaQbwaSbtaYawaaaaaCaXbsaQaRaSbtaYawaaaaaaaaaaaaaaaaaaaaaaaaaaaaaaaaaaaaaaaaaa
aaaaaaaaaaaaaaaaaaaaaaaaaaaaaaaaaaaaaaaaaCaXaPaQaRaSaTaWawaaaaaCaXaPaQaRaSaTaWawaaaaaaaaaaaaaaaaaaaaaaaaaaaaaaaaaaaaaaaaaa
aaaaaaaaaaaaaaaaaaaaaaaaaaaaaaaaaaaaaaaaaGbnbnbnbnbnbnbnaIaaaaaGbnbnbnbnbnbnbnaIaaaaaaaaaaaaaaaaaaaaaaaaaaaaaaaaaaaaaaaaaa
aaaaaaaaaaaaaaaaaaaaaaaaaaaaaaaaaaaaaaaaaaaaaaaaaaaaaaaaaaaaaaaaaaaaaaaaaaaaaaaaaaaaaaaaaaaaaaaaaaaaaaaaaaaaaaaaaaaaaaaaaa
aaaaaaaaaaaaaaaaaaaaaaaaaaaaaaaaaaaaaaaaaaaaaaaaaaaaaaaaaaaaaaaaaaaaaaaaaaaaaaaaaaaaaaaaaaaaaaaaaaaaaaaaaaaaaaaaaaaaaaaaaa
"}
