//MAP CONVERTED BY dmm2tgm.py THIS HEADER COMMENT PREVENTS RECONVERSION, DO NOT REMOVE
"aa" = (
/turf/space,
/area/space)
"ab" = (
/turf/simulated/wall/r_wall/hull,
/area/boarding_ship)
"ac" = (
/obj/wallframe_spawn/reinforced_phoron,
/turf/simulated/floor/tiled/techmaint,
/area/boarding_ship)
"ad" = (
/turf/simulated/wall/r_wall,
/area/boarding_ship)
"ae" = (
/turf/simulated/floor/tiled/techmaint,
/area/boarding_ship)
"af" = (
/obj/structure/boarding/shipportal,
/obj/urist_intangible/triggers/boarding_landmark,
/turf/simulated/floor/tiled/techmaint,
/area/boarding_ship)
"ag" = (
/turf/simulated/floor/tiled/techfloor,
/area/boarding_ship)
"ah" = (
/obj/structure/shuttle/engine/propulsion/burst{
	icon_state = "propulsion";
	dir = 8
	},
/turf/space,
/area/boarding_ship)
"ai" = (
/obj/structure/window/reinforced{
	dir = 4
	},
/obj/structure/shuttle/engine/heater{
	dir = 8
	},
/turf/simulated/floor/plating/airless,
/area/boarding_ship)
"aj" = (
/obj/machinery/door/airlock/hatch{
	autoset_access = 0
	},
/turf/simulated/floor/tiled/techfloor,
/area/boarding_ship)
"ak" = (
/obj/machinery/shipweapons/beam/lightlaser{
	shipid = null
	},
/turf/simulated/floor/tiled/techfloor,
/area/boarding_ship)
"al" = (
/obj/structure/closet/secure_closet/engineering_electrical,
/turf/simulated/floor/tiled/techfloor,
/area/boarding_ship)
"am" = (
/obj/structure/reagent_dispensers/fueltank,
/turf/simulated/floor/tiled/techfloor,
/area/boarding_ship)
"an" = (
/obj/structure/closet/crate/secure/phoron,
/obj/item/tank/phoron,
/obj/item/tank/phoron,
/turf/simulated/floor/tiled/techfloor,
/area/boarding_ship)
"ao" = (
/obj/machinery/door/airlock/hatch{
	autoset_access = 0
	},
/turf/simulated/floor/tiled/steel_grid,
/area/boarding_ship)
"ap" = (
/obj/structure/table/standard,
/obj/item/stack/material/glass{
	amount = 50
	},
/obj/item/stack/material/glass{
	amount = 50
	},
/obj/floor_decal/industrial/outline/yellow,
/turf/simulated/floor/tiled/techfloor,
/area/boarding_ship)
"aq" = (
/obj/machinery/door/airlock/hatch{
	hackProof = 1;
	heat_proof = 1;
	req_access = list("ACCESS_CENT_GENERAL");
	autoset_access = 0
	},
/turf/simulated/floor/tiled/techfloor,
/area/boarding_ship)
"ar" = (
/turf/simulated/floor/tiled/steel_grid,
/area/boarding_ship)
"as" = (
/obj/machinery/door/airlock/hatch{
	hackProof = 1;
	req_access = list("ACCESS_CENT_GENERAL");
	autoset_access = 0
	},
/turf/simulated/floor/tiled/steel_grid,
/area/boarding_ship)
"at" = (
/obj/urist_intangible/triggers/ai_defender_landmark/terran/marine,
/turf/simulated/floor/tiled/steel_grid,
/area/boarding_ship)
"au" = (
/obj/structure/table/rack{
	dir = 8
	},
/obj/item/storage/belt/utility,
/obj/item/clothing/suit/storage/hazardvest,
/obj/item/clothing/suit/storage/hazardvest,
/obj/item/tank/oxygen_emergency_extended,
/obj/item/storage/toolbox/electrical,
/obj/floor_decal/industrial/outline/yellow,
/turf/simulated/floor/tiled/techfloor,
/area/boarding_ship)
"av" = (
/obj/structure/window/reinforced{
	dir = 4
	},
/obj/structure/shuttle/engine/heater{
	icon_state = "heater";
	dir = 8
	},
/turf/simulated/floor/plating/airless,
/area/boarding_ship)
"aw" = (
/obj/structure/closet/toolcloset,
/obj/floor_decal/industrial/outline/yellow,
/turf/simulated/floor/tiled/techfloor,
/area/boarding_ship)
"ax" = (
/obj/floor_decal/industrial/outline/yellow,
/turf/simulated/floor/tiled/techfloor,
/area/boarding_ship)
"ay" = (
/turf/simulated/floor/tiled/white,
/area/boarding_ship)
"az" = (
/obj/structure/assaultshieldgen,
/turf/simulated/floor/tiled/techfloor,
/area/boarding_ship)
"aA" = (
/obj/structure/closet/secure_closet/engineering_electrical,
/obj/floor_decal/industrial/outline/yellow,
/turf/simulated/floor/tiled/techfloor,
/area/boarding_ship)
"aB" = (
/obj/structure/hygiene/toilet{
	dir = 4
	},
/obj/machinery/light/small{
	dir = 8
	},
/turf/simulated/floor/tiled/freezer,
/area/boarding_ship)
"aC" = (
/obj/machinery/door/airlock/hatch{
	hackProof = 1;
	heat_proof = 1;
	req_access = list("ACCESS_CENT_GENERAL");
	autoset_access = 0
	},
/turf/simulated/floor/tiled/freezer,
/area/boarding_ship)
"aD" = (
/turf/simulated/floor/tiled/freezer,
/area/boarding_ship)
"aE" = (
/obj/structure/table/standard,
/obj/item/storage/firstaid/o2{
	pixel_x = 4;
	pixel_y = 6
	},
/obj/item/storage/firstaid/toxin,
/obj/item/storage/firstaid/fire{
	pixel_x = 2;
	pixel_y = 3
	},
/turf/simulated/floor/tiled/white,
/area/boarding_ship)
"aF" = (
/obj/machinery/vending/coffee,
/obj/structure/window/reinforced/tinted/frosted,
/turf/simulated/floor/tiled/steel_grid,
/area/boarding_ship)
"aG" = (
/obj/structure/bed/chair,
/turf/simulated/floor/tiled/steel_grid,
/area/boarding_ship)
"aH" = (
/obj/structure/bed/chair/urist/shuttle{
	icon_state = "shuttlechair";
	dir = 4
	},
/turf/simulated/floor/tiled/techfloor,
/area/boarding_ship)
"aI" = (
/turf/simulated/floor/tiled/dark/monotile,
/area/boarding_ship)
"aJ" = (
/obj/machinery/computer/modular/preset/security,
/turf/simulated/floor/tiled/techmaint,
/area/boarding_ship)
"aK" = (
/obj/structure/table/standard,
/obj/item/storage/firstaid/fire,
/obj/item/storage/firstaid/regular{
	pixel_x = 2;
	pixel_y = 3
	},
/obj/item/crowbar,
/obj/item/extinguisher,
/turf/simulated/floor/tiled/techmaint,
/area/boarding_ship)
"aL" = (
/obj/machinery/computer/modular/preset/cardslot/command,
/turf/simulated/floor/tiled/techmaint,
/area/boarding_ship)
"aM" = (
/obj/structure/table/standard,
/obj/item/storage/lockbox,
/turf/simulated/floor/tiled/dark/monotile,
/area/boarding_ship)
"aN" = (
/obj/structure/bed/chair,
/turf/simulated/floor/tiled/techfloor,
/area/boarding_ship)
"aO" = (
/obj/structure/table/rack/dark,
/obj/random/firstaid,
/obj/random/firstaid,
/turf/simulated/floor/tiled/techfloor,
/area/boarding_ship)
"aP" = (
/obj/structure/table/rack/dark,
/obj/random/projectile,
/obj/random/projectile,
/obj/random/handgun,
/turf/simulated/floor/tiled/techfloor,
/area/boarding_ship)
"aQ" = (
/obj/structure/table/rack/dark,
/obj/random/ammo,
/obj/random/ammo,
/obj/random/ammo,
/obj/random/ammo,
/obj/random/ammo,
/turf/simulated/floor/tiled/techfloor,
/area/boarding_ship)
"aR" = (
/obj/structure/closet/secure_closet/engineering_welding,
/obj/floor_decal/industrial/outline/yellow,
/turf/simulated/floor/tiled/techfloor,
/area/boarding_ship)
"aS" = (
/obj/structure/table/standard,
/obj/item/reagent_containers/ivbag/blood/human/opos{
	pixel_x = 4;
	pixel_y = 2
	},
/obj/item/reagent_containers/ivbag/blood/human/opos{
	pixel_x = 4;
	pixel_y = 2
	},
/obj/item/reagent_containers/ivbag/blood/human/oneg{
	pixel_x = -5;
	pixel_y = -1
	},
/obj/item/reagent_containers/ivbag/blood/human/oneg{
	pixel_x = -5;
	pixel_y = -1
	},
/obj/machinery/light{
	dir = 4
	},
/turf/simulated/floor/tiled/white,
/area/boarding_ship)
"aT" = (
/obj/structure/bed/nice,
/obj/item/bedsheet/purple,
/obj/structure/curtain/open/bed,
/turf/simulated/floor/tiled/steel_grid,
/area/boarding_ship)
"aU" = (
/obj/structure/bed/chair{
	dir = 4
	},
/turf/simulated/floor/tiled/steel_grid,
/area/boarding_ship)
"aV" = (
/obj/structure/table/standard,
/turf/simulated/floor/tiled/steel_grid,
/area/boarding_ship)
"aW" = (
/obj/structure/bed/chair/urist/shuttle{
	icon_state = "shuttlechair";
	dir = 1
	},
/turf/simulated/floor/tiled/techmaint,
/area/boarding_ship)
"aX" = (
/obj/machinery/door/airlock/hatch{
	autoset_access = 0
	},
/turf/simulated/floor/tiled/dark/monotile,
/area/boarding_ship)
"aY" = (
/obj/structure/closet/fridge,
/obj/floor_decal/industrial/outline/yellow,
/turf/simulated/floor/tiled/techfloor,
/area/boarding_ship)
"aZ" = (
/obj/structure/hygiene/toilet{
	dir = 4
	},
/turf/simulated/floor/tiled/freezer,
/area/boarding_ship)
"ba" = (
/obj/structure/iv_stand,
/turf/simulated/floor/tiled/white,
/area/boarding_ship)
"bb" = (
/obj/structure/bed/chair{
	dir = 1
	},
/turf/simulated/floor/tiled/steel_grid,
/area/boarding_ship)
"bc" = (
/obj/structure/table/standard,
/obj/item/device/radio/off,
/turf/simulated/floor/tiled/dark/monotile,
/area/boarding_ship)
"bd" = (
/obj/wallframe_spawn/reinforced,
/turf/simulated/floor/tiled/techmaint,
/area/boarding_ship)
"be" = (
/obj/structure/artilleryplaceholder{
	icon_state = "4"
	},
/turf/simulated/floor/tiled/techfloor/grid,
/area/boarding_ship)
"bf" = (
/obj/structure/artilleryplaceholder{
	icon_state = "5"
	},
/turf/simulated/floor/tiled/techfloor/grid,
/area/boarding_ship)
"bg" = (
/obj/structure/artilleryplaceholder{
	icon_state = "3"
	},
/turf/simulated/floor/tiled/techfloor/grid,
/area/boarding_ship)
"bh" = (
/obj/structure/artilleryplaceholder{
	icon_state = "8"
	},
/turf/simulated/floor/tiled/techfloor/grid,
/area/boarding_ship)
"bi" = (
/obj/structure/artilleryplaceholder{
	icon_state = "6"
	},
/turf/simulated/floor/tiled/techfloor/grid,
/area/boarding_ship)
"bj" = (
/obj/structure/artilleryplaceholder{
	icon_state = "7"
	},
/turf/simulated/floor/tiled/techfloor/grid,
/area/boarding_ship)
"bk" = (
/obj/structure/artilleryplaceholder{
	icon_state = "9"
	},
/turf/simulated/floor/tiled/techfloor/grid,
/area/boarding_ship)
"bl" = (
/obj/structure/artilleryplaceholder{
	icon_state = "10"
	},
/turf/simulated/floor/tiled/techfloor/grid,
/area/boarding_ship)
"bm" = (
/obj/structure/artilleryplaceholder{
	icon_state = "11"
	},
/turf/simulated/floor/tiled/techfloor/grid,
/area/boarding_ship)
"bn" = (
/obj/structure/artilleryplaceholder{
	icon_state = "12"
	},
/turf/simulated/floor/tiled/techfloor/grid,
/area/boarding_ship)
"bo" = (
/obj/wallframe_spawn/reinforced_phoron,
/turf/space,
/area/boarding_ship)
"bp" = (
/obj/urist_intangible/triggers/ai_defender_landmark/terran/space_marine,
/turf/simulated/floor/tiled/techfloor,
/area/boarding_ship)
"bq" = (
/obj/urist_intangible/triggers/ai_defender_landmark/terran/space_marine,
/turf/simulated/floor/tiled/white,
/area/boarding_ship)
"br" = (
/obj/structure/table/standard,
/obj/item/storage/firstaid/o2{
	pixel_x = 2;
	pixel_y = 2
	},
/obj/item/storage/firstaid/regular,
/turf/simulated/floor/tiled/white,
/area/boarding_ship)
"bs" = (
/obj/urist_intangible/triggers/ai_defender_landmark/terran/space_marine,
/turf/simulated/floor/tiled/dark/monotile,
/area/boarding_ship)
"bt" = (
/obj/structure/bed/chair/urist/shuttle{
	icon_state = "shuttlechair";
	dir = 4
	},
/obj/urist_intangible/triggers/ai_defender_landmark/terran/officer,
/turf/simulated/floor/tiled/dark/monotile,
/area/boarding_ship)
"bu" = (
/obj/machinery/computer/modular/preset/cardslot/command{
	dir = 8
	},
/turf/simulated/floor/tiled/dark/monotile,
/area/boarding_ship)
"bv" = (
/obj/structure/artilleryplaceholder{
	icon_state = "16"
	},
/turf/simulated/floor/tiled/techfloor/grid,
/area/boarding_ship)
"bw" = (
/obj/structure/artilleryplaceholder{
	icon_state = "17"
	},
/turf/simulated/floor/tiled/techfloor/grid,
/area/boarding_ship)
"bx" = (
/obj/structure/artilleryplaceholder{
	icon_state = "15"
	},
/turf/simulated/floor/tiled/techfloor/grid,
/area/boarding_ship)
"by" = (
/obj/structure/artilleryplaceholder{
	icon_state = "21"
	},
/turf/simulated/floor/tiled/techfloor/grid,
/area/boarding_ship)
"bz" = (
/obj/structure/artilleryplaceholder{
	icon_state = "18"
	},
/turf/simulated/floor/tiled/techfloor/grid,
/area/boarding_ship)
"bA" = (
/obj/structure/artilleryplaceholder{
	icon_state = "19"
	},
/turf/simulated/floor/tiled/techfloor/grid,
/area/boarding_ship)
"bB" = (
/obj/structure/artilleryplaceholder{
	icon_state = "20"
	},
/turf/simulated/floor/tiled/techfloor/grid,
/area/boarding_ship)
"bC" = (
/obj/structure/artilleryplaceholder{
	icon_state = "22"
	},
/turf/simulated/floor/tiled/techfloor/grid,
/area/boarding_ship)
"bD" = (
/obj/structure/artilleryplaceholder{
	icon_state = "23"
	},
/turf/simulated/floor/tiled/techfloor/grid,
/area/boarding_ship)
"bE" = (
/obj/structure/artilleryplaceholder{
	icon_state = "24"
	},
/turf/simulated/floor/tiled/techfloor/grid,
/area/boarding_ship)
"bF" = (
/obj/structure/closet/crate/secure/phoron,
/obj/item/tank/phoron,
/obj/item/tank/phoron,
/obj/floor_decal/industrial/outline/yellow,
/turf/simulated/floor/tiled/techfloor,
/area/boarding_ship)
"bG" = (
/obj/structure/hygiene/shower{
	dir = 4;
	icon_state = "shower";
	pixel_x = 5
	},
/obj/structure/curtain/open/shower,
/turf/simulated/floor/tiled/freezer,
/area/boarding_ship)
"bH" = (
/obj/machinery/sleeper{
	dir = 8
	},
/obj/machinery/light{
	dir = 4
	},
/turf/simulated/floor/tiled/white,
/area/boarding_ship)
"bI" = (
/obj/structure/table/standard,
/obj/item/material/folder/clipboard,
/obj/item/pen,
/turf/simulated/floor/tiled/dark/monotile,
/area/boarding_ship)
"bJ" = (
/obj/structure/artilleryplaceholder/decorative{
	icon_state = "27"
	},
/turf/simulated/floor/tiled/techfloor/grid,
/area/boarding_ship)
"bK" = (
/obj/structure/artilleryplaceholder/decorative{
	icon_state = "26"
	},
/turf/simulated/floor/tiled/techfloor/grid,
/area/boarding_ship)
"bL" = (
/turf/simulated/floor/tiled/techfloor/grid,
/area/boarding_ship)
"bM" = (
/obj/structure/artilleryplaceholder/decorative{
	icon_state = "29"
	},
/turf/simulated/floor/tiled/techfloor/grid,
/area/boarding_ship)
"bN" = (
/obj/structure/artilleryplaceholder/decorative{
	icon_state = "30"
	},
/obj/structure/artilleryplaceholder/decorative{
	icon_state = "28"
	},
/obj/machinery/constructable_frame/computerframe,
/turf/simulated/floor/tiled/techfloor/grid,
/area/boarding_ship)
"bO" = (
/obj/structure/artilleryplaceholder/decorative{
	icon_state = "31"
	},
/turf/simulated/floor/tiled/techfloor/grid,
/area/boarding_ship)
"bP" = (
/obj/structure/artilleryplaceholder/decorative{
	icon_state = "34"
	},
/turf/simulated/floor/tiled/techfloor/grid,
/area/boarding_ship)
"bQ" = (
/obj/structure/cable{
	icon_state = "0-2";
	pixel_y = 1;
	d2 = 2
	},
/obj/machinery/power/apc/high{
	cell_type = /obj/item/cell/infinite;
	dir = 8;
	name = "west bump";
	pixel_x = -24
	},
/turf/simulated/floor/tiled/techfloor,
/area/boarding_ship)
"bR" = (
/obj/structure/reagent_dispensers/watertank,
/obj/floor_decal/industrial/outline/yellow,
/turf/simulated/floor/tiled/techfloor,
/area/boarding_ship)
"bS" = (
/obj/structure/hygiene/sink{
	dir = 4;
	icon_state = "sink";
	pixel_x = 11;
	pixel_y = 0
	},
/turf/simulated/floor/tiled/freezer,
/area/boarding_ship)
"bT" = (
/obj/structure/window/reinforced/tinted/frosted{
	icon_state = "window";
	dir = 1
	},
/turf/simulated/floor/tiled/steel_grid,
/area/boarding_ship)
"bU" = (
/obj/urist_intangible/triggers/ai_defender_landmark/terran/marine,
/turf/simulated/floor/tiled/dark/monotile,
/area/boarding_ship)
"bV" = (
/obj/urist_intangible/trigger/template_loader/ships,
/turf/simulated/floor/tiled/dark/monotile,
/area/boarding_ship)
"bW" = (
/obj/structure/bed/chair/urist/shuttle,
/turf/simulated/floor/tiled/techmaint,
/area/boarding_ship)
"bX" = (
/obj/urist_intangible/triggers/ai_defender_landmark/terran/marine,
/turf/simulated/floor/tiled/techfloor,
/area/boarding_ship)
"bY" = (
/obj/machinery/power/smes/buildable,
/obj/structure/cable,
/turf/simulated/floor/tiled/techfloor,
/area/boarding_ship)
"bZ" = (
/obj/structure/reagent_dispensers/fueltank,
/obj/floor_decal/industrial/outline/yellow,
/turf/simulated/floor/tiled/techfloor,
/area/boarding_ship)
"ca" = (
/obj/machinery/vending/medical{
	req_access = newlist()
	},
/turf/simulated/floor/tiled/white,
/area/boarding_ship)
"cb" = (
/obj/machinery/vending/urist/sustenance,
/turf/simulated/floor/tiled/steel_grid,
/area/boarding_ship)
"cc" = (
/obj/machinery/vending/hotfood,
/turf/simulated/floor/tiled/steel_grid,
/area/boarding_ship)
"cd" = (
/obj/machinery/vending/snix,
/turf/simulated/floor/tiled/steel_grid,
/area/boarding_ship)
"ce" = (
/obj/machinery/microwave,
/obj/structure/table/standard,
/turf/simulated/floor/tiled/steel_grid,
/area/boarding_ship)
"cf" = (
/obj/machinery/computer/modular/preset/cardslot/command{
	dir = 1
	},
/turf/simulated/floor/tiled/techmaint,
/area/boarding_ship)
"cg" = (
/obj/structure/table/standard,
/obj/machinery/microwave,
/turf/simulated/floor/tiled/techmaint,
/area/boarding_ship)
"ch" = (
/obj/structure/table/standard,
/obj/item/storage/box/donkpocket_mixed,
/turf/simulated/floor/tiled/techmaint,
/area/boarding_ship)
"ci" = (
/obj/structure/table/standard,
/obj/item/paper_bin,
/turf/simulated/floor/tiled/dark/monotile,
/area/boarding_ship)
"cj" = (
/obj/structure/bed/chair{
	dir = 1
	},
/turf/simulated/floor/tiled/techfloor,
/area/boarding_ship)
"ck" = (
/obj/structure/table/rack,
/obj/random/tool,
/obj/random/tool,
/obj/random/tool,
/turf/simulated/floor/tiled/techfloor,
/area/boarding_ship)
"cl" = (
/obj/structure/table/rack,
/obj/random/material,
/obj/random/powercell,
/obj/random/powercell,
/obj/random/material,
/turf/simulated/floor/tiled/techfloor,
/area/boarding_ship)
"cm" = (
/obj/structure/table/rack,
/obj/random/toolbox,
/obj/random/material,
/obj/random/tool,
/turf/simulated/floor/tiled/techfloor,
/area/boarding_ship)
"cn" = (
/obj/structure/closet/crate/secure/weapon,
/obj/item/gun/energy/laser,
/obj/item/gun/energy/ionrifle,
/obj/item/gun/energy/gun/small,
/obj/floor_decal/industrial/outline/yellow,
/turf/simulated/floor/tiled/techfloor,
/area/boarding_ship)
"co" = (
/obj/structure/table/standard,
/obj/item/storage/toolbox/mechanical,
/obj/floor_decal/industrial/outline/yellow,
/obj/item/stack/material/rods/fifty,
/turf/simulated/floor/tiled/techfloor,
/area/boarding_ship)
"cp" = (
/obj/structure/table/standard,
/obj/item/storage/toolbox/mechanical{
	pixel_x = -2;
	pixel_y = -1
	},
/obj/item/stack/material/steel{
	amount = 50
	},
/obj/item/stack/material/glass{
	amount = 50
	},
/obj/item/clothing/gloves/insulated,
/obj/floor_decal/industrial/outline/yellow,
/obj/item/stack/material/rods/fifty,
/turf/simulated/floor/tiled/techfloor,
/area/boarding_ship)
"cq" = (
/obj/urist_intangible/triggers/defender_landmark/terran,
/turf/simulated/floor/tiled/techmaint,
/area/boarding_ship)

(1,1,1) = {"
aa
aa
aa
aa
aa
aa
aa
aa
aa
aa
aa
aa
aa
aa
aa
aa
aa
aa
aa
aa
aa
aa
aa
aa
aa
aa
aa
aa
aa
aa
aa
aa
aa
aa
aa
aa
aa
aa
aa
aa
aa
aa
aa
aa
aa
aa
aa
aa
aa
aa
aa
aa
aa
aa
aa
aa
aa
aa
aa
aa
aa
"}
(2,1,1) = {"
aa
aa
aa
aa
aa
aa
aa
aa
aa
aa
aa
aa
aa
aa
aa
aa
aa
aa
aa
aa
aa
aa
aa
aa
aa
aa
aa
aa
aa
aa
aa
aa
aa
aa
aa
aa
aa
aa
aa
aa
aa
aa
aa
aa
aa
aa
aa
aa
aa
aa
aa
aa
aa
aa
aa
aa
aa
aa
aa
aa
aa
"}
(3,1,1) = {"
aa
aa
aa
aa
aa
aa
aa
aa
aa
aa
aa
aa
aa
aa
aa
aa
aa
aa
aa
aa
aa
aa
aa
aa
aa
aa
aa
aa
aa
aa
aa
aa
aa
aa
aa
aa
aa
aa
aa
aa
aa
aa
aa
aa
aa
aa
aa
aa
aa
aa
aa
aa
aa
aa
aa
aa
aa
aa
aa
aa
aa
"}
(4,1,1) = {"
aa
aa
aa
aa
aa
aa
aa
aa
aa
aa
aa
aa
aa
aa
aa
aa
aa
aa
aa
aa
aa
aa
aa
aa
aa
aa
aa
aa
aa
aa
aa
aa
aa
aa
aa
aa
aa
aa
aa
aa
aa
aa
aa
aa
aa
aa
aa
aa
aa
aa
aa
aa
aa
aa
aa
aa
aa
aa
aa
aa
aa
"}
(5,1,1) = {"
aa
aa
aa
aa
aa
aa
aa
aa
aa
aa
aa
aa
aa
aa
aa
aa
aa
aa
aa
aa
aa
aa
ab
ab
ah
ah
ah
ah
ah
ah
ah
ah
ah
ab
ab
aa
aa
aa
aa
aa
aa
aa
aa
aa
aa
aa
aa
aa
aa
aa
aa
aa
aa
aa
aa
aa
aa
aa
aa
aa
aa
"}
(6,1,1) = {"
aa
aa
aa
aa
aa
aa
aa
aa
aa
aa
aa
aa
aa
aa
aa
aa
aa
aa
aa
aa
aa
aa
ab
ad
av
av
av
av
av
av
av
av
av
ad
ab
aa
aa
aa
aa
aa
aa
aa
aa
aa
aa
aa
aa
aa
aa
aa
aa
aa
aa
aa
aa
aa
aa
aa
aa
aa
aa
"}
(7,1,1) = {"
aa
aa
aa
aa
aa
aa
aa
aa
aa
aa
aa
aa
aa
aa
aa
aa
aa
aa
aa
aa
aa
aa
ab
ad
ad
ad
ad
ad
ad
ad
ad
ad
ad
ad
ab
aa
aa
aa
aa
aa
aa
aa
aa
aa
aa
aa
aa
aa
aa
aa
aa
aa
aa
aa
aa
aa
aa
aa
aa
aa
aa
"}
(8,1,1) = {"
aa
aa
aa
aa
aa
aa
aa
aa
aa
aa
aa
aa
aa
aa
aa
aa
aa
aa
aa
aa
aa
aa
ab
ad
ad
ag
ag
ag
ag
ag
bQ
bY
ad
ad
ab
aa
aa
aa
aa
aa
aa
aa
aa
aa
aa
aa
aa
aa
aa
aa
aa
aa
aa
aa
aa
aa
aa
aa
aa
aa
aa
"}
(9,1,1) = {"
aa
aa
aa
aa
aa
aa
aa
aa
aa
aa
aa
aa
aa
aa
aa
aa
aa
aa
aa
aa
ab
ab
ab
ad
ad
az
ag
ag
ag
ag
ag
az
ad
ad
ab
ab
ab
aa
aa
aa
aa
aa
aa
aa
aa
aa
aa
aa
aa
aa
aa
aa
aa
aa
aa
aa
aa
aa
aa
aa
aa
"}
(10,1,1) = {"
aa
aa
aa
aa
aa
aa
aa
aa
aa
aa
aa
aa
aa
aa
aa
aa
aa
aa
aa
aa
ab
ad
ad
ad
ad
ad
ad
ad
aj
ad
ad
ad
ad
ad
ad
ad
ab
aa
aa
aa
aa
aa
aa
aa
aa
aa
aa
aa
aa
aa
aa
aa
aa
aa
aa
aa
aa
aa
aa
aa
aa
"}
(11,1,1) = {"
aa
aa
aa
aa
aa
aa
aa
aa
aa
aa
aa
aa
aa
aa
aa
aa
aa
aa
aa
aa
ab
ad
ap
au
aw
aA
aR
aY
ag
bF
bR
bZ
cn
co
cp
ad
ab
aa
aa
aa
aa
aa
aa
aa
aa
aa
aa
aa
aa
aa
aa
aa
aa
aa
aa
aa
aa
aa
aa
aa
aa
"}
(12,1,1) = {"
aa
aa
aa
aa
aa
aa
aa
aa
aa
aa
aa
aa
aa
aa
aa
aa
aa
aa
aa
aa
ab
ad
ag
ag
ag
ag
ag
ag
bp
ag
ag
ag
ag
ag
ag
ad
ab
aa
aa
aa
aa
aa
aa
aa
aa
aa
aa
aa
aa
aa
aa
aa
aa
aa
aa
aa
aa
aa
aa
aa
aa
"}
(13,1,1) = {"
aa
aa
aa
aa
aa
aa
aa
aa
aa
aa
aa
aa
aa
aa
aa
aa
aa
aa
aa
aa
ab
ad
ag
ag
ax
ax
ax
ax
ax
ax
ax
ax
ax
ag
ag
ad
ab
aa
aa
aa
aa
aa
aa
aa
aa
aa
aa
aa
aa
aa
aa
aa
aa
aa
aa
aa
aa
aa
aa
aa
aa
"}
(14,1,1) = {"
aa
aa
aa
aa
aa
aa
aa
aa
aa
aa
aa
aa
aa
aa
aa
aa
aa
aa
aa
aa
ab
ad
ag
ag
ad
ad
ad
ad
ad
ad
ad
ad
ad
ag
ag
ad
ab
aa
aa
aa
aa
aa
aa
aa
aa
aa
aa
aa
aa
aa
aa
aa
aa
aa
aa
aa
aa
aa
aa
aa
aa
"}
(15,1,1) = {"
aa
aa
aa
aa
aa
aa
aa
aa
aa
aa
aa
aa
aa
aa
aa
aa
aa
aa
aa
aa
ab
ad
aq
aq
ad
aB
ad
aZ
ad
bG
bG
bG
ad
aq
aq
ad
ab
aa
aa
aa
aa
aa
aa
aa
aa
aa
aa
aa
aa
aa
aa
aa
aa
aa
aa
aa
aa
aa
aa
aa
aa
"}
(16,1,1) = {"
aa
aa
aa
aa
aa
aa
aa
aa
aa
aa
aa
aa
aa
aa
aa
aa
aa
aa
aa
aa
ab
ad
ar
ar
ad
aC
ad
aC
ad
aD
aD
aD
ad
ar
ar
ad
ab
aa
aa
aa
aa
aa
aa
aa
aa
aa
aa
aa
aa
aa
aa
aa
aa
aa
aa
aa
aa
aa
aa
aa
aa
"}
(17,1,1) = {"
aa
aa
aa
aa
aa
aa
aa
aa
aa
aa
aa
aa
aa
aa
aa
aa
aa
aa
aa
aa
ab
ad
ar
ar
ad
aD
aD
aD
aD
aD
bS
bS
ad
ar
ar
ad
ab
aa
aa
aa
aa
aa
aa
aa
aa
aa
aa
aa
aa
aa
aa
aa
aa
aa
aa
aa
aa
aa
aa
aa
aa
"}
(18,1,1) = {"
aa
aa
aa
aa
aa
aa
aa
aa
aa
aa
aa
aa
aa
aa
aa
aa
aa
aa
aa
aa
ab
ad
ar
ar
ad
ad
ad
ad
ad
aC
ad
ad
ad
ar
ar
ad
ab
aa
aa
aa
aa
aa
aa
aa
aa
aa
aa
aa
aa
aa
aa
aa
aa
aa
aa
aa
aa
aa
aa
aa
aa
"}
(19,1,1) = {"
aa
aa
aa
aa
aa
aa
aa
aa
aa
aa
aa
aa
aa
aa
aa
aa
aa
aa
aa
aa
ab
ad
ar
ar
ay
ay
ay
ay
bq
ay
ay
ay
ay
ar
ar
ad
ab
aa
aa
aa
aa
aa
aa
aa
aa
aa
aa
aa
aa
aa
aa
aa
aa
aa
aa
aa
aa
aa
aa
aa
aa
"}
(20,1,1) = {"
aa
aa
aa
aa
aa
aa
aa
aa
aa
aa
aa
aa
aa
aa
aa
aa
aa
ab
ab
aa
ab
ad
ar
ar
ay
ay
ay
ay
ay
ay
ay
ay
ay
ar
ar
ad
ab
aa
ab
ab
aa
aa
aa
aa
aa
aa
aa
aa
aa
aa
aa
aa
aa
aa
aa
aa
aa
aa
aa
aa
aa
"}
(21,1,1) = {"
aa
aa
aa
aa
aa
aa
aa
aa
aa
aa
aa
aa
aa
aa
aa
aa
aa
ab
ad
ah
ad
ad
ar
ar
ad
aE
aS
ba
br
bH
bH
ca
ad
ar
ar
ad
ad
ah
ad
ab
aa
aa
aa
aa
aa
aa
aa
aa
aa
aa
aa
aa
aa
aa
aa
aa
aa
aa
aa
aa
aa
"}
(22,1,1) = {"
aa
aa
aa
aa
aa
aa
aa
aa
aa
aa
aa
aa
aa
aa
aa
aa
aa
ab
ad
ai
ad
ad
as
as
ad
ad
ad
ad
ad
ad
ad
ad
ad
as
as
ad
ad
ai
ad
ab
aa
aa
aa
aa
aa
aa
aa
aa
aa
aa
aa
aa
aa
aa
aa
aa
aa
aa
aa
aa
aa
"}
(23,1,1) = {"
aa
aa
aa
aa
aa
aa
aa
aa
aa
aa
aa
aa
aa
aa
aa
aa
aa
ab
ad
ag
ad
ad
ar
ar
ad
aF
aT
aT
aT
aT
bT
cb
ad
ar
ar
ad
ad
ag
ad
ab
aa
aa
aa
aa
aa
aa
aa
aa
aa
aa
aa
aa
aa
aa
aa
aa
aa
aa
aa
aa
aa
"}
(24,1,1) = {"
aa
aa
aa
aa
aa
aa
aa
aa
aa
aa
aa
aa
aa
aa
aa
aa
aa
ab
ad
ag
ad
ad
at
ar
ao
ar
ar
ar
at
ar
ar
cc
ad
ar
ar
ad
ad
ag
ad
ab
aa
aa
aa
aa
aa
aa
aa
aa
aa
aa
aa
aa
aa
aa
aa
aa
aa
aa
aa
aa
aa
"}
(25,1,1) = {"
aa
aa
aa
aa
aa
aa
aa
aa
aa
aa
aa
aa
aa
aa
aa
aa
aa
ab
ad
ag
al
ad
ar
ar
ad
ar
aU
ar
ar
ar
ar
cd
ad
ar
ar
ad
al
ag
ad
ab
aa
aa
aa
aa
aa
aa
aa
aa
aa
aa
aa
aa
aa
aa
aa
aa
aa
aa
aa
aa
aa
"}
(26,1,1) = {"
aa
aa
aa
aa
aa
aa
aa
aa
aa
aa
aa
aa
aa
aa
aa
aa
aa
ab
ad
ag
am
ad
ar
ar
ad
aG
aV
bb
ar
ar
ar
ce
ad
ar
ar
ad
am
ag
ad
ab
aa
aa
aa
aa
aa
aa
aa
aa
aa
aa
aa
aa
aa
aa
aa
aa
aa
aa
aa
aa
aa
"}
(27,1,1) = {"
aa
aa
aa
aa
aa
aa
aa
aa
aa
aa
aa
aa
aa
aa
aa
aa
aa
ab
ad
ag
an
ad
ar
ar
ad
ad
ad
ad
ao
ad
ad
ad
ad
ar
ar
ad
an
ag
ad
ab
aa
aa
aa
aa
aa
aa
aa
aa
aa
aa
aa
aa
aa
aa
aa
aa
aa
aa
aa
aa
aa
"}
(28,1,1) = {"
aa
aa
aa
aa
aa
aa
aa
aa
aa
aa
aa
aa
aa
aa
aa
aa
aa
ab
ad
ag
ag
ad
ar
ar
ad
aH
ag
aH
aI
aH
ag
aH
ad
ar
at
ad
ag
ag
ad
ab
aa
aa
aa
aa
aa
aa
aa
aa
aa
aa
aa
aa
aa
aa
aa
aa
aa
aa
aa
aa
aa
"}
(29,1,1) = {"
aa
aa
aa
aa
aa
aa
aa
aa
aa
aa
aa
aa
aa
aa
aa
aa
aa
ab
ad
ag
ag
ad
ar
ar
ad
aH
ag
aH
aI
aH
ag
aH
ad
ar
ar
ad
ag
ag
ad
ab
aa
aa
aa
aa
aa
aa
aa
aa
aa
aa
aa
aa
aa
aa
aa
aa
aa
aa
aa
aa
aa
"}
(30,1,1) = {"
aa
aa
aa
aa
aa
aa
aa
aa
aa
aa
aa
aa
aa
aa
aa
aa
aa
ab
ad
ag
ag
ad
ar
ar
ao
aI
aI
aI
aI
aI
bU
aI
ao
ar
ar
ad
ag
ag
ad
ab
aa
aa
aa
aa
aa
aa
aa
aa
aa
aa
aa
aa
aa
aa
aa
aa
aa
aa
aa
aa
aa
"}
(31,1,1) = {"
aa
aa
aa
aa
aa
aa
aa
aa
aa
aa
aa
aa
aa
aa
aa
aa
aa
ab
ad
ag
ag
aj
ar
ar
ao
aI
aI
aI
aI
aI
bV
aI
ao
ar
ar
aj
ag
ag
ad
ab
aa
aa
aa
aa
aa
aa
aa
aa
aa
aa
aa
aa
aa
aa
aa
aa
aa
aa
aa
aa
aa
"}
(32,1,1) = {"
aa
aa
aa
aa
aa
aa
aa
aa
aa
aa
aa
aa
aa
aa
aa
aa
ab
ab
ad
ag
ag
ad
ar
ar
ad
aJ
aW
ae
aI
ae
bW
cf
ad
ar
ar
ad
ag
ag
ad
ab
aa
aa
aa
aa
aa
aa
aa
aa
aa
aa
aa
aa
aa
aa
aa
aa
aa
aa
aa
aa
aa
"}
(33,1,1) = {"
aa
aa
aa
aa
aa
aa
aa
aa
aa
aa
aa
aa
aa
aa
aa
aa
ab
ad
ad
aj
aj
ad
ar
ar
ad
aK
ae
ae
bs
ae
ae
cg
ad
ar
ar
ad
aj
aj
ad
ab
ab
aa
aa
aa
aa
aa
aa
aa
aa
aa
aa
aa
aa
aa
aa
aa
aa
aa
aa
aa
aa
"}
(34,1,1) = {"
aa
aa
aa
aa
aa
aa
aa
aa
aa
aa
aa
aa
aa
aa
aa
aa
ac
ae
ae
ae
ae
ad
ar
ar
ad
aK
ae
ae
aI
ae
ae
ch
ad
ar
ar
ad
ae
ae
ae
ae
ac
aa
aa
aa
aa
aa
aa
aa
aa
aa
aa
aa
aa
aa
aa
aa
aa
aa
aa
aa
aa
"}
(35,1,1) = {"
aa
aa
aa
aa
aa
aa
aa
aa
aa
aa
aa
aa
aa
aa
aa
aa
ac
ae
af
ae
ae
ao
ar
ar
ad
aL
aW
ae
aI
ae
bW
cf
ad
ar
ar
ao
ae
ae
ae
ae
ac
aa
aa
aa
aa
aa
aa
aa
aa
aa
aa
aa
aa
aa
aa
aa
aa
aa
aa
aa
aa
"}
(36,1,1) = {"
aa
aa
aa
aa
aa
aa
aa
aa
aa
aa
aa
aa
aa
aa
aa
aa
ac
ae
ae
ae
ae
ao
ar
ar
ao
aI
aI
aI
bt
aI
aI
aI
ao
ar
ar
ao
ae
ae
cq
ae
ac
aa
aa
aa
aa
aa
aa
aa
aa
aa
aa
aa
aa
aa
aa
aa
aa
aa
aa
aa
aa
"}
(37,1,1) = {"
aa
aa
aa
aa
aa
aa
aa
aa
aa
aa
aa
aa
aa
aa
aa
aa
ac
ae
ae
ae
ae
ad
ar
ar
ad
aM
aI
bc
bu
bI
aI
ci
ad
ar
ar
ad
ae
ae
ae
ae
ac
aa
aa
aa
aa
aa
aa
aa
aa
aa
aa
aa
aa
aa
aa
aa
aa
aa
aa
aa
aa
"}
(38,1,1) = {"
aa
aa
aa
aa
aa
aa
aa
aa
aa
aa
aa
aa
aa
aa
aa
aa
ab
ad
ag
ak
ad
ad
ar
ar
ad
ad
aX
bd
bd
bd
aX
ad
ad
ar
ar
ad
ad
ag
ak
ad
ab
aa
aa
aa
aa
aa
aa
aa
aa
aa
aa
aa
aa
aa
aa
aa
aa
aa
aa
aa
aa
"}
(39,1,1) = {"
aa
aa
aa
aa
aa
aa
aa
aa
aa
aa
aa
aa
aa
aa
aa
aa
ab
ad
ag
ag
ad
ad
ar
ar
ad
aN
ag
ag
ag
ag
ag
cj
ad
ar
ar
ad
ad
ag
ag
ad
ab
aa
aa
aa
aa
aa
aa
aa
aa
aa
aa
aa
aa
aa
aa
aa
aa
aa
aa
aa
aa
"}
(40,1,1) = {"
aa
aa
aa
aa
aa
aa
aa
aa
aa
aa
aa
aa
aa
aa
aa
aa
ab
ab
ac
ac
ab
ad
ar
ar
ad
aN
ag
ag
ag
ag
ag
cj
ad
ar
ar
ad
ab
ac
ac
ab
ab
aa
aa
aa
aa
aa
aa
aa
aa
aa
aa
aa
aa
aa
aa
aa
aa
aa
aa
aa
aa
"}
(41,1,1) = {"
aa
aa
aa
aa
aa
aa
aa
aa
aa
aa
aa
aa
aa
aa
aa
aa
aa
aa
aa
aa
ab
ad
ar
ar
ad
ag
ag
ag
ag
ag
ag
ag
ad
ar
ar
ad
ab
aa
aa
aa
aa
aa
aa
aa
aa
aa
aa
aa
aa
aa
aa
aa
aa
aa
aa
aa
aa
aa
aa
aa
aa
"}
(42,1,1) = {"
aa
aa
aa
aa
aa
aa
aa
aa
aa
aa
aa
aa
aa
aa
aa
aa
aa
aa
aa
aa
ab
ad
ar
ar
as
ag
ag
be
bv
bJ
ag
ag
as
ar
ar
ad
ab
aa
aa
aa
aa
aa
aa
aa
aa
aa
aa
aa
aa
aa
aa
aa
aa
aa
aa
aa
aa
aa
aa
aa
aa
"}
(43,1,1) = {"
aa
aa
aa
aa
aa
aa
aa
aa
aa
aa
aa
aa
aa
aa
aa
aa
aa
aa
aa
aa
ab
ad
ar
ar
as
ag
ag
bf
bw
bK
ag
ag
as
ar
ar
ad
ab
aa
aa
aa
aa
aa
aa
aa
aa
aa
aa
aa
aa
aa
aa
aa
aa
aa
aa
aa
aa
aa
aa
aa
aa
"}
(44,1,1) = {"
aa
aa
aa
aa
aa
aa
aa
aa
aa
aa
aa
aa
aa
aa
aa
aa
aa
aa
aa
aa
ab
ad
ad
ad
ad
ag
ag
bg
bx
bK
ag
ag
ad
ad
ad
ad
ab
aa
aa
aa
aa
aa
aa
aa
aa
aa
aa
aa
aa
aa
aa
aa
aa
aa
aa
aa
aa
aa
aa
aa
aa
"}
(45,1,1) = {"
aa
aa
aa
aa
aa
aa
aa
aa
aa
aa
aa
aa
aa
aa
aa
aa
aa
aa
aa
aa
ab
ab
ab
ab
ad
ag
ag
bh
by
bL
ag
ag
ad
ab
ab
ab
ab
aa
aa
aa
aa
aa
aa
aa
aa
aa
aa
aa
aa
aa
aa
aa
aa
aa
aa
aa
aa
aa
aa
aa
aa
"}
(46,1,1) = {"
aa
aa
aa
aa
aa
aa
aa
aa
aa
aa
aa
aa
aa
aa
aa
aa
aa
aa
aa
aa
aa
aa
aa
ab
ad
ag
ag
bi
bz
bM
bX
ag
ad
ab
aa
aa
aa
aa
aa
aa
aa
aa
aa
aa
aa
aa
aa
aa
aa
aa
aa
aa
aa
aa
aa
aa
aa
aa
aa
aa
aa
"}
(47,1,1) = {"
aa
aa
aa
aa
aa
aa
aa
aa
aa
aa
aa
aa
aa
aa
aa
aa
aa
aa
aa
aa
aa
aa
aa
ab
ad
ag
ag
bj
bA
bN
ag
ag
ad
ab
aa
aa
aa
aa
aa
aa
aa
aa
aa
aa
aa
aa
aa
aa
aa
aa
aa
aa
aa
aa
aa
aa
aa
aa
aa
aa
aa
"}
(48,1,1) = {"
aa
aa
aa
aa
aa
aa
aa
aa
aa
aa
aa
aa
aa
aa
aa
aa
aa
aa
aa
aa
aa
aa
aa
ab
ad
ag
ag
bh
bB
bO
ag
ag
ad
ab
aa
aa
aa
aa
aa
aa
aa
aa
aa
aa
aa
aa
aa
aa
aa
aa
aa
aa
aa
aa
aa
aa
aa
aa
aa
aa
aa
"}
(49,1,1) = {"
aa
aa
aa
aa
aa
aa
aa
aa
aa
aa
aa
aa
aa
aa
aa
aa
aa
aa
aa
aa
aa
aa
aa
ab
ad
ag
ag
bk
by
bL
ag
ag
ad
ab
aa
aa
aa
aa
aa
aa
aa
aa
aa
aa
aa
aa
aa
aa
aa
aa
aa
aa
aa
aa
aa
aa
aa
aa
aa
aa
aa
"}
(50,1,1) = {"
aa
aa
aa
aa
aa
aa
aa
aa
aa
aa
aa
aa
aa
aa
aa
aa
aa
aa
aa
aa
aa
aa
aa
ab
ad
aO
ag
bl
bC
bL
ag
ck
ad
ab
aa
aa
aa
aa
aa
aa
aa
aa
aa
aa
aa
aa
aa
aa
aa
aa
aa
aa
aa
aa
aa
aa
aa
aa
aa
aa
aa
"}
(51,1,1) = {"
aa
aa
aa
aa
aa
aa
aa
aa
aa
aa
aa
aa
aa
aa
aa
aa
aa
aa
aa
aa
aa
aa
aa
ab
ad
aP
ag
bm
bD
bP
ag
cl
ad
ab
aa
aa
aa
aa
aa
aa
aa
aa
aa
aa
aa
aa
aa
aa
aa
aa
aa
aa
aa
aa
aa
aa
aa
aa
aa
aa
aa
"}
(52,1,1) = {"
aa
aa
aa
aa
aa
aa
aa
aa
aa
aa
aa
aa
aa
aa
aa
aa
aa
aa
aa
aa
aa
aa
aa
ab
ad
aQ
ag
bn
bE
bL
ag
cm
ad
ab
aa
aa
aa
aa
aa
aa
aa
aa
aa
aa
aa
aa
aa
aa
aa
aa
aa
aa
aa
aa
aa
aa
aa
aa
aa
aa
aa
"}
(53,1,1) = {"
aa
aa
aa
aa
aa
aa
aa
aa
aa
aa
aa
aa
aa
aa
aa
aa
aa
aa
aa
aa
aa
aa
aa
ab
ad
ad
ag
ag
ag
ag
ag
ad
ad
ab
aa
aa
aa
aa
aa
aa
aa
aa
aa
aa
aa
aa
aa
aa
aa
aa
aa
aa
aa
aa
aa
aa
aa
aa
aa
aa
aa
"}
(54,1,1) = {"
aa
aa
aa
aa
aa
aa
aa
aa
aa
aa
aa
aa
aa
aa
aa
aa
aa
aa
aa
aa
aa
aa
aa
ab
ab
ad
ad
ag
ag
ag
ad
ad
ab
ab
aa
aa
aa
aa
aa
aa
aa
aa
aa
aa
aa
aa
aa
aa
aa
aa
aa
aa
aa
aa
aa
aa
aa
aa
aa
aa
aa
"}
(55,1,1) = {"
aa
aa
aa
aa
aa
aa
aa
aa
aa
aa
aa
aa
aa
aa
aa
aa
aa
aa
aa
aa
aa
aa
aa
aa
ab
ab
ab
bo
bo
bo
ab
ab
ab
aa
aa
aa
aa
aa
aa
aa
aa
aa
aa
aa
aa
aa
aa
aa
aa
aa
aa
aa
aa
aa
aa
aa
aa
aa
aa
aa
aa
"}
(56,1,1) = {"
aa
aa
aa
aa
aa
aa
aa
aa
aa
aa
aa
aa
aa
aa
aa
aa
aa
aa
aa
aa
aa
aa
aa
aa
aa
aa
aa
aa
aa
aa
aa
aa
aa
aa
aa
aa
aa
aa
aa
aa
aa
aa
aa
aa
aa
aa
aa
aa
aa
aa
aa
aa
aa
aa
aa
aa
aa
aa
aa
aa
aa
"}
(57,1,1) = {"
aa
aa
aa
aa
aa
aa
aa
aa
aa
aa
aa
aa
aa
aa
aa
aa
aa
aa
aa
aa
aa
aa
aa
aa
aa
aa
aa
aa
aa
aa
aa
aa
aa
aa
aa
aa
aa
aa
aa
aa
aa
aa
aa
aa
aa
aa
aa
aa
aa
aa
aa
aa
aa
aa
aa
aa
aa
aa
aa
aa
aa
"}
(58,1,1) = {"
aa
aa
aa
aa
aa
aa
aa
aa
aa
aa
aa
aa
aa
aa
aa
aa
aa
aa
aa
aa
aa
aa
aa
aa
aa
aa
aa
aa
aa
aa
aa
aa
aa
aa
aa
aa
aa
aa
aa
aa
aa
aa
aa
aa
aa
aa
aa
aa
aa
aa
aa
aa
aa
aa
aa
aa
aa
aa
aa
aa
aa
"}
(59,1,1) = {"
aa
aa
aa
aa
aa
aa
aa
aa
aa
aa
aa
aa
aa
aa
aa
aa
aa
aa
aa
aa
aa
aa
aa
aa
aa
aa
aa
aa
aa
aa
aa
aa
aa
aa
aa
aa
aa
aa
aa
aa
aa
aa
aa
aa
aa
aa
aa
aa
aa
aa
aa
aa
aa
aa
aa
aa
aa
aa
aa
aa
aa
"}
(60,1,1) = {"
aa
aa
aa
aa
aa
aa
aa
aa
aa
aa
aa
aa
aa
aa
aa
aa
aa
aa
aa
aa
aa
aa
aa
aa
aa
aa
aa
aa
aa
aa
aa
aa
aa
aa
aa
aa
aa
aa
aa
aa
aa
aa
aa
aa
aa
aa
aa
aa
aa
aa
aa
aa
aa
aa
aa
aa
aa
aa
aa
aa
aa
"}
(61,1,1) = {"
aa
aa
aa
aa
aa
aa
aa
aa
aa
aa
aa
aa
aa
aa
aa
aa
aa
aa
aa
aa
aa
aa
aa
aa
aa
aa
aa
aa
aa
aa
aa
aa
aa
aa
aa
aa
aa
aa
aa
aa
aa
aa
aa
aa
aa
aa
aa
aa
aa
aa
aa
aa
aa
aa
aa
aa
aa
aa
aa
aa
aa
"}
