//MAP CONVERTED BY dmm2tgm.py THIS HEADER COMMENT PREVENTS RECONVERSION, DO NOT REMOVE
"a" = (
/obj/urist_intangible/mapmanip/marker/submap/insert/nerva/cargo_storage,
/turf/template_noop,
/area/template_noop)
"e" = (
/turf/template_noop,
/area/template_noop)

(1,1,1) = {"
e
a
"}
(2,1,1) = {"
e
e
"}
