"a" = (/turf/simulated/mineral,/area/space)
"b" = (/turf/simulated/floor/exoplanet/snow,/area/space)
"c" = (/obj/floor_decal/corner/red{icon_state = "corner_white"; dir = 1},/obj/floor_decal/corner/yellow{dir = 8},/obj/floor_decal/snow,/turf/simulated/floor/exoplanet/snow,/area/space)
"d" = (/obj/floor_decal/snow,/turf/simulated/floor/exoplanet/snow,/area/space)
"e" = (/obj/floor_decal/corner/yellow{icon_state = "corner_white"; dir = 1},/obj/floor_decal/corner/red{icon_state = "corner_white"; dir = 8},/obj/floor_decal/snow,/mob/living/exosuit/premade/hoverpod/fighter/large/alien{dir = 4},/turf/simulated/floor/exoplanet/snow,/area/space)
"f" = (/obj/floor_decal/corner/yellow{icon_state = "corner_white"; dir = 1},/obj/floor_decal/corner/red{icon_state = "corner_white"; dir = 8},/obj/floor_decal/snow,/turf/simulated/floor/exoplanet/snow,/area/space)
"g" = (/turf/simulated/wall/alium,/area/space)
"h" = (/turf/simulated/floor/fixed/alium,/area/space)
"i" = (/turf/simulated/floor/fixed/alium/curves,/area/space)
"j" = (/turf/simulated/floor/greengrid,/area/space)
"k" = (/obj/floor_decal/solarpanel,/obj/floor_decal/snow,/turf/simulated/floor/exoplanet/snow,/area/space)
"l" = (/turf/simulated/floor/exoplanet/ice,/area/space)

(1,1,1) = {"
aaaaaaaaaaaaaaaaaaaaaaaaaaaaaaaaaaaaaaaaaaaaaaaaaaaaaaaaaaaaaaaaaaaaaaaaaaaaaaaaaaaaaaaaaaaaaaaaaaaa
aaaaaaaaaaaaaaaaaaaaaaaaaaaaaaaaaaaaaaaaaaaaaaaaaaaaaaaaaaaaaaaaaaaaaaaaaaaaaaaaaaaaaaaaaaaaaaaaaaaa
aaaaaaaaaaaaaaaaaaaaaaaaabbbbbbbbbbbbbbaaaaaaaaaaaaaaaaaaaaaaaaaabbbbbbbbaaaabbbbbbbbbbbbbbbaaaaaaaa
aaaaaaaaabbbbbbbbbbbbbbbbbbbbbbbbbbbbbbbaaaaaaaaaaaaaaaaaaaaaaaabbbbbbbbbbbbbbbbbbbbbbbbbbbbbbaaaaaa
aaaaaaabbbbbbbbbbbbbbbbbbbbbbbbbbbbbbbbbbaaaaaaaaaaaaaaaaaaaaabbbbbbbbbbbbbbbbbbbbbbbbbbbbbbbbbaaaaa
aaaaabbbbbbbbbbbbbbbbbbbbbbbbbbbbbbbbbbbbbbaaaaaaaaaaaaaaaaaabbbbbbbbbbbbbbbbbbbbbbbbbbbbbbbbbbbaaaa
aaaabbbbbbbbbbbbbbbbbbbbbbbbbbbbbbbbbbbbbbbbaaaaaaaaaaaaaaaabbbbbbbbbbbbbbbbbbbbbbbbbbbbbbbbbbbbaaaa
aaaabbbbbbbbbbbbbbbbbbbbbbbbbbbbbbbbbbbbbbbbaaaaaaaaaaaaaaabbbbbbbbbbbbbbbbbbbbbbbbbbbbbbbbbbbbbbaaa
aaabbbbbbbbbbbbbbbbbbbbbbbbbbbbbbbbbbbbbbbbbaaaaaaaaaaaaaabbbbbbbbbbbbbbbbbbbbbbbbbbbbbbbbbbbbbbbaaa
aaabbbbbbccccccccccccccccccccccdddddddbbbbbbbaaaaaaaaaaaaabbbbbbbbbbbbbbbbbbbbbbbbbbbbbbbbbbbbbbbaaa
aaabbbbbbdddddddddddddddddddddddddddddbbbbbbbaaaaaaaaaaaabbbbbbbbbbbbbbbbbbbbbbbbbbbbbbbbbbbbbbbbaaa
aaabbbbbbefffffffffffffffffffffdddddddbbbbbbaaaaaaaaaaaaabbbbbbbbbbbbbbbbbbbbbbbbbbbbbbbbbbbbbbbbbaa
aaaabbbbbbbbbbbbbbbbbbbbbbbbbbbbbbbbbbbbbbbaaaaaaaaaaaaaabbbbbbbbbbbbbbbbbbbbbbbbbbbbbbbbbbbbbbbbbaa
aaaaabbbbbbbbbbbbbbbbbbbbbbbbbbbbbbbbbbbbbbaaaaaaaaaaaaabbbbbbbbbbbbbbbbbbbbbbbbbbbbbbbbbbbbbbbbbbaa
aaaaaghbhbbbbbbbbbbbbbbbbbbbbbbbbbbbbbbbbbbaaaaaaaaaaaaabbbbbbbbbbbbbbbbbbbbbbbbbbbbbbbbbbbbbbbbbbaa
aaaaaghhbbbbbbbbbbbbbbbbbbbbbbbbbbbbbbbbbbaaaaaaaaaaaaaabbbbbbbbbbbbbbbbbbbbbbbbbbbbbbbbbbbbbbbbbbaa
aaaaaghhhgbbbbbbiiiiibbbbbbbbbbbbbbbbbbabbaaaaaaaaaaaaaabbbbbbbbbbbbbbbbbbbbbbbbbbbbbbbbbbbbbbbbbbaa
aaaaaghhhgggggggiiiiigggggggggggggggggaabaaaaaaaaaaaaaaaabbbbbbbbbbbbbbbbbbbbbbbbbbbbbbbbbbbbbbbbaaa
aaaaaghhhgagiiiiiiiiiiiiighhhhhhhhhhhgaaaaaaaaaaaaaaaaaaabbbbbbbbbbbbbbbbbbbbbbbbbbbbbbbbbbbbbbbbaaa
aaaaaghhhgagiiiiiiiiiiiiighhhhhhhhhhhgaaaaaaaaaaaaaaaaaaaabbbbbbbbbbbbbbbbbbbbbbbbbbbbbbbbbbbbbbaaaa
aaaaaghhhgagiiiiiiiiiiiiighhghhhhhhhhgaaaaaaaaaaaaaaaaaaaabbbbbbbbbbbbbbbbbbbbbbbbbbbbbbbbbbbbbbaaaa
aaaaaghhhgagiiiiiiiiiiiiighhghhhhhhhhgaaaaaaaaaaaaaaaaaaaaabbbbbbbbbbbbbbbbbbbbbbbbbbbbbbbbbbbbbaaaa
aaaaaghhhgggiiiiiiiiiiiiighhggggggggggaaaaaaaaaaaaaaaaaaaaaabbbbbbbbbbbbbbbbbbbbbbbbbbbbbbbbbbbbaaaa
aaaaaghhhhhhiiiiijjjiiiiighhghhhhhhhhgaaaaaaaaaaaaaaaaaaaaaaabbbbbbbbbbbbbbbbbbbbbbbbbbbbbbbbbbaaaaa
aaaaaghhhhhhiiiiijjjiiiiighhghhhhhhhhgaaaaaaaaaaaaaaaaaaaaaaaabbbbbbbbbbbbbbbbbbbbbbbbbbbbbbbaaaaaaa
aaaaaghhhhhhiiiiijjjiiiiighhhhhhhhhhhgaaaaaaaaaaaaaaaaaaaaaaaaabbbbbbbbbbbbbbbbbbbbbbbbbbbbbaaaaaaaa
aaaaagggghhgiiiiiiiiiiiiighhhhhhhhhhhgaaaaaaaaaaaabbbbbbaaaaaaabbbbbbbbbbbbbbbbbbbbbbbbbbbbbbaaaaaaa
aaaaaaaaghhgiiiiiiiiiiiiighhghhhhhhhhgaaaaaaaaaabbbbbbbbbaaaaaaabbbbbbbbbbbbbbbbbbbbbbbbbbbabbaaaaaa
aaaaaaaaghhgiiiiiiiiiiiiighhghhhhhhhhgaaaaaaaaabbbkbkbkbkbaaaaaaabbbbbbbbbbbbbbbbbbbbbbbbbaaabaaaaaa
aaaaaaaaghhgiiiiiiiiiiiiighhghhhhhhhhgaaaaaaaabbbbkbkbkbkbbaaaaaaabbbbbbbbbbbbbbbbbbbbbbbaaaabaaaaaa
aaaaaaaaghhgiiiiiiiiiiiiighhghhhhhhhhgggggaaabbbbbkbkbkbkbbaaaaaaaaaaabbbbbbbbaaaaaabbaaaaaaabaaaaaa
aaaaaaaaghhggggggggggggggghhgggggggggghhhgggbbbbbbbbbbbbbbbbaaaaaaaaaaaaabaaaaaaaaaaaaaaaaaabbaaaaaa
aaaaaaaaghhhhhhhhhhhhhhhhhhhhhhhhhhhhhhhhhhbbbbbbbbbbbbbbbbbaaaaaaaaaaaabbaaaaaaaaaaaaabbbbbbaaaaaaa
aaaaaaaaghhhhhhhhhhhhhhhhhhhhhhhhhhhhhhhhhhhbbbbbbbbbbbbbbbbbaaaaaaaaabbbaaaaabbaaaaaabbabbbbbbbaaaa
aaaaaaagggggghhggggggggggghhgggggggggghhhgggbbbbbbkbkbkbkbbbbaaaaaaaaabaaabbbbbbbbbbbbbaabbaaaabbaaa
aaaaaaaghhhhhhhhhhhhhghhhghhgaaaaabaagggggaaababbbkbkbkbkbbbbaaaaaaaabbaabbaaaaaaaaaaaaabbaaaaabbaaa
aaaaaaaghhhhhhhhhhhhhghggghhggaaabbbbaaaaaaabbaabbkbkbkbkbbbbaaaaaaabbaabbaaaaaaaaaaaaabbaaaaabbaaaa
aaaaaaaghhggggggghhhhghghhhhhhgabbaabaaaaaabbaaaabbbbbbbbbbbaaaaaaabbaabbbbbbbbbbbbbbbbbaaaabbbaaaaa
aaaaaaaghhghhhhhghhhhghghhhhhhgabaaabbbaaabbaaaaaaabbbbbbbbaaaaaabbbaaabbbaaaaaabbaaaaaaaaabbaaaaaaa
aaaaaaaghhhhhhhhgggggghgahhhhhaabaaaaabbbbbaabbaaaaaaaaaaaaaaaabbbaaabbbaaaaaaaaaaaaaaaaabbbaaaaaaaa
aaaaaaaghhhhhhhhghhhhhhgahbbhaaabaaaaaaaaaaabbbbaaaaaaaaaaaaaaabaaaabaaaaabbbbbbbbbbaaabbbaaaaaaaaaa
aaaaaaaghhhhhhhhggggggggabbbaaaabbaaabbbaaaabaaaaaaaaaaaaaaaaaabaabbbaabbbbaaaaaaaabbbbbaaaaaaaaaaaa
aaaaaaagggghhhhhgaaaaaaaabhbbaaaabbbbbabbbbabaaaaaaaaaaaaaaaabbbbbbaaabbaaaaaaaaaaaaaabbaaaaaaaaaaaa
aaaaaaaaaagggggggaaaaaaabbbbbbbaaaaaaaaaaabababaaaaaaaaaabbbbbaaaaaaabbaaaaaaaaaaaaaaaabbaaaaaaaaaaa
aaaaaaaaaaaaaaaaaaaaaaaabbbbbbbaaaaaaabbaababbbaaaaaaaabbbaaaaaabbbbbbbaaabbbbbbbbbbbaaabbbaaaaaaaaa
aaaaaaaaaaaaaaaaaaaaaaaabbbbhbaaaaaaabbbbababbbaaaaaaabbaaaaabbbbbaabbbbabbbaaaaaaabbbaaaabbaaaaaaaa
aaaaaaaaaaaaaaaaaaaaaaaaahbbbaaaaaaaabaabbbbbaaaaaabbbbaaabbbbbbaaabbabbababbaaaaaaaabbbaaabaaaaaaaa
aaaaaaaaaaaaaaaaaaaaaaaaaabbaaaaaaaaabbaaaaaaaaaaabbaaaabbbbbbaaaabbaaababaabaaaaaaaaabbaaabaaaaaaaa
aaaaaaaaaaaaaaaaaaaaaaaaabbbbbaaaaaaaabbaaaaaabbbbbaaaaabbaaaaaabbbaaaababaaabbbbbbbaaabbabbaaaaaaaa
aaaaaaaaaaaaaaaaaaaaaaabbbbbbbbbbbaaaaabbaaaabbaaaaabbaabbaaaaabbaaababbabbaaaaaaaabbbaabbbbaaaaaaaa
aaaaaaaaaaaaaaaaaaaaabbbbbbbbbbbbbbaaaaabbbabbaaaaabbbbabaaaabbbaaabbabbaabaaabbbbaaabaabbbaaaaaaaaa
aaaaaaaaaaaaaaaaaaabbbbbbbbbbbbbbbbbbaaaaabbbaabbbbbaababbaabbaaabbbaabbaabaabbaabbaabaabbaaaaaaaaaa
aaaaaaaaaaaaaaaaabbbbbbbbbbbbbbbbbbbbbaaaaabbaababbaaababbbabaabbbbaaabbaababbaaaabbabaabbaaaaaaaaaa
aaaaaaaaaaaaaaabbbbbbbbbbbbbbbbbbbbbbbbaaaaabbaaabbaabbaabbababbabbaabbbaabbbaabbaabbbaaabaaaaaaaaaa
aaaaaaaaaaaaabbbbbbbbbbbbbbbbbbbbbbbbbbbaaaaabbbbbaabbaaabbabbbaabbbabbbaaabaabbbbaaabaaabaaaaaaaaaa
aaaaaaaaaaaabbbbbbbbbbbbbbbbbbbbbbbbbbbbbaaaaaaaaaaabaaaaabaabaabbabbbbbbaababbbbbaabbaaabaaaaaaaaaa
aaaaaaaaaaabbbbbbbbbbbbbbbbbbbbbbbbbbbbbbbbaaaaaaaaabaaaaabaaaabbaabbaabbabbabbbbaabbaaabbaaaaaaaaaa
aaaaaaaaaabbbbbbbbbbbbbbbbbbbbbbbbbbbbbbbbbbaaaaaaaabaaaabbaaabbbabbaaabbabaabbbbbbbaaaabaaaaaaaaaaa
aaaaaaaaabbbbbbbbbbbbbbbbbbbbbbbbbbbbbbbbbbbbbbaaaaabbaaabaaaabaaabbaaabbababbbaabbaaaabbaaaaaaaaaaa
aaaaaaaabbbbbbbbbbbbbbbbbbbbbbbbbbbbbbbbbbbbbbbbaaaaaabbbbaaaababaabbaabbababaaabbaaaabbaaaaaaaaaaaa
aaaaaaabbbbbbbbbbbbbbbbbbbbbbbbbbbbbbbbbbbbbbbbbbaaaaaaaabbaaabbbbabbaaabbbaaabbbaaaabbaaaaaaaaaaaaa
aaaaaaabbbbbbbbbbbbbbbbbbbbbbbbbbbbbbbbbbbbbbbbbbbaaaaaaaabbaaabbbaabbaaabbaabbaaaaaabaaaaaaaaaaaaaa
aaaaaabbbbbbbbbbbbbbbbbbbbbbbbbbbbbbbbbbbbbbbbbbbbbbbaaaaaabbbbbbbbaabbbabbbabaaaabbbbaaaaaaaaaaaaaa
aaaaaabbbbbbbbbbbbbbbbbbbbbbbbbbbbbbbbbbbbbbbbbbbbbbbbbaaaaaaabbabbbaabbaaabbbbbbbbbbaaaaaaaaaaaaaaa
aaaaabbbbbbbbbbbbbbbbbbbbbbbbbbbbbbbbbbbbbbbbbbbbbbbbbbbaaaaaaaaaabbbaabbaaaaaaabbbaaaaaaaaaaaaaaaaa
aaaaabbbbbbbbbbbbbbbbbbbbbbbbbbbbbbbbbbbbbbbbbbbbbbbbbbbbaaaaaaaaaaabbaabbaaaaaaaaaaaaaaaaaaaaaaaaaa
aaaabbbbbbbbbbbbbbbbbbbbbbbbbbbbbbbbbbbbbbbbbbbbbbbbbbbbbbaaaaaaaaaaaaaabbbbbbbbbbbbbbbbbbbbbbbaaaaa
aaaabbbbbbbbbbbbbbbbbbbbbbbbbbbbbbbbbbbbbbbbbbbbbbbbbbbbbbbaaaaaaaaabbbbbbbbbbbbbbbbbbbbbbbbbbbbbbbb
aaabbbbbbbbbbbbbbbbbbbbbbbbbbbbbbbbbbbbbbbbbbbbbbbbbbbbbbbbbaaaabbbbbbbbbbbbbbbbbbbbbbbbbbbbbbbbbbbb
aaabbbbbbbbbbbbbbbbbbbbbbbbbbbbbbbbbbbbbbbbbbbbbbbbbbbbbbbbbaaabbbbbbbbbbbbbbbbbbbbbbbbbbbbbbbbbbbbb
aaabbbbbbbbbbbbbbbbbbbbbbbbbbbbbbbbbbbbbbbbbbbbbbbbbbbbbbbbbaabbbbbbbbbbbbbbbbbbbbbbbbbbbbbbbbbbbbbb
aabbbbbbbbbbbbbbbbbbbbbbbbbbbbbbbbbbbbbbbbbbbbbbbbbbbbbbbbbbaabbbbbbbbbbbbbbbbbbbbbbbbbbbbbbbbbbbbbb
aabbbbbbbbbbbbbbbbbbbbbbbbbbbbbbbbbbbbbbbbbbbbbbbbbbbbbbbbbbbabbbbbbbbbbbbbbbbbbbbbbbbbbbbbbbbbbbbbb
aabbbbbbbbbbbbbbbbbbbbbbbbbbbbbbbbbbbbbbbbbbbbbbbbbbbbbbbbbbbbbbbbbbbbbbbbbbbbbbbbbbbbbbbbbbbbbbbbbb
aabbbbbbbbbbbbbbbbbbbbbbbbbbbbbbbbbbbbbbbbbbbbbbbbbbbbbbbbbbbbbbbbbbbbbbbbbbbbbbbbbbbbbbbbbbbbbbbbbb
aabbbbbbbbbbbbbbbbbbbbbbbbbbbbbbbbbbbbbbbbbbbbbbbbbbbbbbbbbbbbbbbbbbbbbbbbbbbbbbbbbbbbbbbbbbbbbbbbbb
aabbbbbbbbbbbbbbbbbbbbbbbbbbbbbbbbbbbbbbbbbbbbbbbbbbbbbbaabbbbbbbbbbbbbbbbbbbbbbbbbbbbbbbbbbbbbbbbbb
aabbbbbbbbbbbbbbbbbbbbbbbbbbbbbbbbbbbbbbbbbbbbbbbbbbbbbaaaabbbbbbbbbbbbbbbbbbbbbbbbbbbbbbbbbbbbbbbbb
aabbbbbbbbbbbbbbbbbbbbbbbbbbbbbbbbbbbbbbbbbbbbbbbbbbbaaaaaabbbbbbbbbbbbbbbbbbbbbbbbbbbbbbbbbbbbbbbbb
aabbbbbbbbbbbbbbbbbbbbbbbbbbbbbbbbbbbbbbbbbbbbbbbbbbaaaaaaabbbbbbbbbbbbbbbbbbbbbbbbbbbbbbbbbbbbbbbbb
aabbbbbbbbbbbbbbbbbbbbbbbbbbbbbbbbbbbbbbbbbbbbbbbbbbaaaaaaabbbbbbbbbbbbbbbbbbbbbbbbbbbbbbbbbbbbbbbbb
aaabbbbbbbbbbbbbbbbbbbbbbbbbbbbbbbbbbbbbbbbbbbbbbbbaaaaaaaabbbbbbbbbbbbbbbbbbbbbbbbbbbbbbbbbbbbbbbbb
aaabbbbbbbbbbbbbbbbbbbbbbbbbbbbbbbbbbbbbbbbbbbbbbbbaaaaaaabbbbbbbbbbbbbbbbblllllbbbbbbbbbbbbbbbbbbbb
aaabbbbbbbbbbbbbbbbbbbbbbbbbbbbbbbbbbbbbbbbbbbbbbbaaaaaaabbbbbbbbbbbbbbblllllllllbbbbbbbbbbbbbbbbbbb
aaaabbbbbbbbbbbbbbbbbbbbbbbbbbbbbbbbbbbbbbbbbbbbbaaaaaaabbbbbbbbbbbbbbllllllllllllbbbbbbbbbbbbbbbbbb
aaaabbbbbbbbbbbbbbbbbbbbbbbbbbbbbbbbbbbbbbbbbbbbaaaaaaabbbbbbbbbbbbblllllllllllllllbbbbbbbbbbbbbbbbb
aaaabbbbbbbbbbbbbbbbbbbbbbbbbbbbbbbbbbbbbbbbbbbbaaaaaabbbbbbbbbbbbblllllllllllllllllbbbbbbbbbbbbbbbb
aaaabbbbbbbbbbbbbbbbbbbbbbbbbbbbbbbbbbbbbbbbbbbbaaaaabbbbbbbbbbbbbllllllllllllllllllbbbbbbbbbbbbbbbb
aaaaabbbbbbbbbbbbbbbbbbbbbbbbbbbbbbbbbbbbbbbbbbbbaaabbbbbbbbbbbbblllllllllllllllllllbbbbbbbbbbbbbbbb
aaaaabbbbbbbbbbbbbbbbbbbbbbbbbbbbbbbbbbbbbbbbbbbbbbbbbbbbbbbbbbbllllllllllllllllllllbbbbbbbbbbbbbbbb
aaaaaabbbbbbbbbbbbbbbbbbbbbbbbbbbbbbbbbbbbbbbabbbbbbbbbbbbbbbbbbllllllllllllllllllllbbbbbbbbbbbbbbbb
aaaaaabbbbbbbbbbbbbbbbbbbbbbbbbbbbbbbbbbbbaaaaabbbbbbbbbbbbbbbbbllllllllllllllllllllbbbbbbbbbbbbbbbb
aaaaaaabbbbbbbbbbbbbbbbbbbbbbbaaabbbbbbbaaaaaaabbbbbbbbbbbbbbbbbllllllllllllllllllllbbbbbbbbbbbbbbbb
aaaaaaaaaaaaaaaaaaaaaaaaaaaaaaaaaaaaaaaaaaaaaaabbbbbbbbbbbbbbbbbllllllllllllllllllllbbbbbbbbbbbbbbbb
aaaaaaaaaaaaaaaaaaaaaaaaaaaaaaaaaaaaaaaaaaaaaabbbbbbbbbbbbbbbbbbbllllllllllllllllllbbbbbbbbbbbbbbbbb
aaaaaaaaaaaaaaaaaaaaaaaaaaaaaaaaaaaaaaaaaaaaabbbbbbbbbbbbbbbbbbbbbbblllllllllllllbbbbbbbbbbbbbbbbbbb
aaaaaaaaaaaaaaaaaaaaaaaaaaaaaaaaaaaaaaaaaaaaaabbbbbbbbbbbbbbbbbbbbbbbbbbbbbbbbbbbbbbbbbbbbbbbbbbbbbb
aaaaaaaaaaaaaaaaaaaaaaaaaaaaaaaaaaaaaaaaaaaaaabbbbbbbbbbbbbbbbbbbbbbbbbbbbbbbbbbbbbbbbbbbbbbbbbbbbbb
aaaaaaaaaaaaaaaaaaaaaaaaaaaaaaaaaaaaaaaaaaaaabbbbbbbbbbbbbbbbbbbbbbbbbbbbbbbbbbbbbbbbbbbbbbbbbbbbbbb
aaaaaaaaaaaaaaaaaaaaaaaaaaaaaaaaaaaaaaaaaaaaaaaaaaaaaaaaaaaabbbbbbbbbbbbbbbbbbbbbbbbbbbbbbbbbbbbbbbb
"}
