//MAP CONVERTED BY dmm2tgm.py THIS HEADER COMMENT PREVENTS RECONVERSION, DO NOT REMOVE
"ad" = (
/obj/floor_decal/corner/blue/diagonal,
/obj/machinery/body_scanconsole{
	dir = 4
	},
/turf/simulated/floor/tiled/white,
/area/medical/surgery)
"at" = (
/obj/machinery/light{
	dir = 8;
	icon_state = "tube1"
	},
/obj/floor_decal/corner/blue/diagonal,
/obj/machinery/reagentgrinder,
/obj/item/reagent_containers/glass/beaker/large,
/turf/simulated/floor/tiled/white,
/area/medical/surgery)
"cv" = (
/obj/floor_decal/corner/blue/diagonal,
/obj/machinery/chemical_dispenser/full,
/turf/simulated/floor/tiled/white,
/area/medical/surgery)
"eP" = (
/obj/floor_decal/corner/blue/diagonal,
/obj/structure/table/standard,
/obj/item/stack/material/aluminium/fifty,
/obj/item/stack/material/aluminium/fifty,
/obj/item/stack/material/deuterium/fifty,
/obj/item/stack/material/diamond/ten,
/obj/item/stack/material/glass/fifty,
/obj/item/stack/material/glass/fifty,
/obj/item/stack/material/glass/phoronglass,
/obj/item/stack/material/glass/reinforced/fifty,
/obj/item/stack/material/gold/ten,
/obj/item/stack/material/iron,
/obj/item/stack/material/mhydrogen/ten,
/obj/item/stack/material/nullglass/fifty,
/obj/item/stack/material/ocp/fifty,
/obj/item/stack/material/osmium/ten,
/obj/item/stack/material/phoron/fifty,
/obj/item/stack/material/plasteel/fifty,
/obj/item/stack/material/plastic/fifty,
/obj/item/stack/material/platinum/ten,
/obj/item/stack/material/rods/fifty,
/obj/item/stack/material/steel/fifty,
/obj/item/stack/material/steel/fifty,
/obj/item/stack/material/titanium/fifty,
/obj/item/stack/material/tritium/fifty,
/obj/item/stack/material/uranium/fifty,
/turf/simulated/floor/tiled/white,
/area/medical/surgery)
"gk" = (
/obj/floor_decal/corner/blue/diagonal,
/obj/structure/closet/fridge,
/obj/item/reagent_containers/food/condiment/enzyme,
/obj/item/reagent_containers/food/condiment/barbecue,
/turf/simulated/floor/tiled/white,
/area/medical/surgery)
"gm" = (
/obj/machinery/light,
/obj/floor_decal/corner/blue/diagonal,
/obj/machinery/cell_charger,
/obj/structure/table/standard,
/turf/simulated/floor/tiled/white,
/area/medical/surgery)
"gM" = (
/obj/floor_decal/corner/blue/diagonal,
/obj/machinery/biogenerator,
/turf/simulated/floor/tiled/white,
/area/medical/surgery)
"gO" = (
/obj/floor_decal/corner/blue/diagonal,
/obj/machinery/computer/rdconsole/core{
	dir = 1
	},
/turf/simulated/floor/tiled/white,
/area/medical/surgery)
"hK" = (
/obj/floor_decal/corner/blue/diagonal,
/obj/structure/iv_stand,
/obj/item/reagent_containers/ivbag/blood/human/oneg,
/obj/item/reagent_containers/ivbag/blood/human/oneg,
/turf/simulated/floor/tiled/white,
/area/medical/surgery)
"hO" = (
/obj/structure/cable{
	d2 = 2;
	icon_state = "0-2"
	},
/obj/machinery/power/apc{
	dir = 8;
	name = "west bump";
	pixel_x = -24
	},
/obj/floor_decal/corner/blue/diagonal,
/turf/simulated/floor/tiled/white,
/area/medical/surgery)
"iG" = (
/obj/floor_decal/corner/blue/diagonal,
/obj/machinery/vending/robotics,
/turf/simulated/floor/tiled/white,
/area/medical/surgery)
"iN" = (
/obj/floor_decal/corner/blue/diagonal,
/obj/structure/table/glass,
/obj/item/reagent_containers/dropper,
/obj/item/reagent_containers/chem_disp_cartridge/peridaxon,
/obj/item/stack/nanopaste,
/obj/machinery/light{
	dir = 8;
	icon_state = "tube1"
	},
/turf/simulated/floor/tiled/white,
/area/medical/surgery)
"jo" = (
/obj/floor_decal/corner/blue/diagonal,
/obj/machinery/cooker/fryer,
/turf/simulated/floor/tiled/white,
/area/medical/surgery)
"jM" = (
/obj/floor_decal/corner/blue/diagonal,
/obj/structure/closet/fridge/meat,
/turf/simulated/floor/tiled/white,
/area/medical/surgery)
"jS" = (
/obj/floor_decal/corner/blue/diagonal,
/obj/machinery/seed_storage/all,
/turf/simulated/floor/tiled/white,
/area/medical/surgery)
"kA" = (
/obj/floor_decal/corner/blue/diagonal,
/obj/machinery/fabricator,
/turf/simulated/floor/tiled/white,
/area/medical/surgery)
"kL" = (
/obj/floor_decal/corner/blue/diagonal,
/mob/living/bot/farmbot,
/obj/structure/hygiene/sink/kitchen{
	pixel_y = 28
	},
/turf/simulated/floor/tiled/white,
/area/medical/surgery)
"lf" = (
/obj/floor_decal/corner/blue/diagonal,
/obj/machinery/light{
	dir = 4;
	icon_state = "tube1"
	},
/obj/machinery/botany/editor,
/turf/simulated/floor/tiled/white,
/area/medical/surgery)
"lM" = (
/obj/floor_decal/corner/blue/diagonal,
/obj/structure/table/glass,
/obj/item/scalpel/laser,
/obj/item/device/robotanalyzer,
/obj/item/device/scanner/health,
/obj/item/storage/firstaid/adv,
/turf/simulated/floor/tiled/white,
/area/medical/surgery)
"lQ" = (
/obj/floor_decal/corner/blue/diagonal,
/obj/structure/table/standard,
/obj/machinery/chemical_dispenser/bar_soft/full,
/turf/simulated/floor/tiled/white,
/area/medical/surgery)
"ms" = (
/obj/floor_decal/corner/blue/diagonal,
/obj/machinery/atmospherics/unary/cryo_cell,
/turf/simulated/floor/tiled/white,
/area/medical/surgery)
"mQ" = (
/obj/floor_decal/corner/blue/diagonal,
/obj/structure/hygiene/sink{
	dir = 4
	},
/turf/simulated/floor/tiled/white,
/area/medical/surgery)
"mZ" = (
/obj/floor_decal/corner/blue/diagonal,
/obj/machinery/r_n_d/protolathe,
/turf/simulated/floor/tiled/white,
/area/medical/surgery)
"ns" = (
/obj/structure/cable{
	d1 = 1;
	d2 = 2;
	icon_state = "1-2"
	},
/obj/floor_decal/corner/blue/diagonal,
/obj/machinery/washing_machine,
/turf/simulated/floor/tiled/white,
/area/medical/surgery)
"nu" = (
/obj/floor_decal/corner/blue/diagonal,
/obj/structure/table/standard,
/obj/machinery/reagent_temperature,
/turf/simulated/floor/tiled/white,
/area/medical/surgery)
"nw" = (
/obj/floor_decal/corner/blue/diagonal,
/obj/machinery/microwave{
	pixel_x = -3;
	pixel_y = 6
	},
/turf/simulated/floor/tiled/white,
/area/medical/surgery)
"ou" = (
/obj/floor_decal/corner/blue/diagonal,
/obj/machinery/optable,
/turf/simulated/floor/tiled/white,
/area/medical/surgery)
"oy" = (
/obj/floor_decal/corner/blue/diagonal,
/obj/structure/kitchenspike,
/turf/simulated/floor/tiled/white,
/area/medical/surgery)
"oP" = (
/turf/space,
/area/space)
"oU" = (
/obj/floor_decal/corner/blue/diagonal,
/obj/machinery/portable_atmospherics/canister/air,
/obj/machinery/atmospherics/portables_connector{
	dir = 1
	},
/turf/simulated/floor/tiled/white,
/area/medical/surgery)
"oW" = (
/obj/floor_decal/corner/blue/diagonal,
/obj/structure/table/glass,
/obj/item/storage/box/latexgloves,
/obj/item/storage/box/masks,
/obj/item/storage/box/monkeycubes,
/turf/simulated/floor/tiled/white,
/area/medical/surgery)
"pD" = (
/obj/floor_decal/corner/blue/diagonal,
/obj/machinery/atmospherics/unary/vent_scrubber/on,
/turf/simulated/floor/tiled/white,
/area/medical/surgery)
"qw" = (
/obj/landmark/map_data{
	height = 2
	},
/turf/space,
/area/space)
"qx" = (
/obj/floor_decal/corner/blue/diagonal,
/obj/item/stack/material/cardboard/fifty,
/obj/item/stack/material/cloth,
/obj/item/stack/material/generic/bone,
/obj/item/stack/material/generic/brick,
/obj/item/stack/material/generic/skin,
/obj/item/stack/material/leather,
/obj/item/stack/material/wood,
/turf/simulated/floor/tiled/white,
/area/medical/surgery)
"qA" = (
/obj/floor_decal/corner/blue/diagonal,
/obj/machinery/cooker/grill,
/turf/simulated/floor/tiled/white,
/area/medical/surgery)
"qQ" = (
/obj/floor_decal/corner/blue/diagonal,
/obj/machinery/r_n_d/destructive_analyzer,
/turf/simulated/floor/tiled/white,
/area/medical/surgery)
"so" = (
/obj/machinery/light_switch{
	pixel_x = -25
	},
/obj/floor_decal/corner/blue/diagonal,
/obj/machinery/chem_master,
/turf/simulated/floor/tiled/white,
/area/medical/surgery)
"tn" = (
/obj/floor_decal/corner/blue/diagonal,
/obj/structure/table/rack,
/obj/item/stack/animalhide/cat,
/obj/item/stack/animalhide/corgi,
/obj/item/stack/animalhide/human,
/obj/item/stack/animalhide/lizard,
/obj/item/stack/animalhide/xeno,
/obj/item/stack/animalhide/monkey,
/obj/item/stack/hairlesshide,
/turf/simulated/floor/tiled/white,
/area/medical/surgery)
"uA" = (
/obj/floor_decal/corner/blue/diagonal,
/obj/machinery/vitals_monitor,
/turf/simulated/floor/tiled/white,
/area/medical/surgery)
"uM" = (
/obj/machinery/light{
	dir = 1
	},
/obj/floor_decal/corner/blue/diagonal,
/obj/structure/table/glass,
/obj/item/storage/box/syringes,
/obj/item/storage/box/freezer,
/turf/simulated/floor/tiled/white,
/area/medical/surgery)
"uV" = (
/obj/machinery/light{
	dir = 1
	},
/obj/floor_decal/corner/blue/diagonal,
/obj/machinery/vending/hydronutrients/generic,
/turf/simulated/floor/tiled/white,
/area/medical/surgery)
"vD" = (
/obj/floor_decal/corner/blue/diagonal,
/obj/machinery/cooker/cereal,
/turf/simulated/floor/tiled/white,
/area/medical/surgery)
"vL" = (
/obj/floor_decal/corner/blue/diagonal,
/obj/machinery/recharge_station,
/turf/simulated/floor/tiled/white,
/area/medical/surgery)
"wF" = (
/obj/floor_decal/corner/blue/diagonal,
/obj/structure/table/marble,
/obj/item/material/rollingpin,
/obj/item/material/chopping_board,
/obj/item/reagent_containers/food/condiment/small/saltshaker{
	pixel_x = -3
	},
/obj/item/reagent_containers/food/condiment/small/peppermill{
	pixel_x = 3
	},
/turf/simulated/floor/tiled/white,
/area/medical/surgery)
"xe" = (
/obj/floor_decal/corner/blue/diagonal,
/obj/machinery/cooker/oven,
/turf/simulated/floor/tiled/white,
/area/medical/surgery)
"xr" = (
/obj/floor_decal/corner/blue/diagonal,
/obj/machinery/floor_light/mapped_off{
	default_light_outer_range = 6;
	default_light_inner_range = 2
	},
/turf/simulated/floor/tiled/white,
/area/medical/surgery)
"xu" = (
/obj/floor_decal/corner/blue/diagonal,
/obj/machinery/portable_atmospherics/hydroponics,
/turf/simulated/floor/tiled/white,
/area/medical/surgery)
"xA" = (
/obj/floor_decal/corner/blue/diagonal,
/obj/machinery/gibber,
/turf/simulated/floor/tiled/white,
/area/medical/surgery)
"yq" = (
/obj/floor_decal/corner/blue/diagonal,
/obj/item/reagent_containers/syringe,
/turf/simulated/floor/tiled/white,
/area/medical/surgery)
"zp" = (
/obj/floor_decal/corner/blue/diagonal,
/obj/structure/table/standard,
/obj/machinery/reagent_temperature,
/turf/simulated/floor/tiled/white,
/area/medical/surgery)
"zN" = (
/obj/floor_decal/corner/blue/diagonal,
/obj/machinery/r_n_d/server/core,
/turf/simulated/floor/tiled/white,
/area/medical/surgery)
"Cr" = (
/obj/floor_decal/corner/blue/diagonal,
/obj/machinery/r_n_d/circuit_imprinter,
/turf/simulated/floor/tiled/white,
/area/medical/surgery)
"CE" = (
/obj/floor_decal/corner/blue/diagonal,
/obj/machinery/atmospherics/pipe/simple/visible/blue{
	dir = 5
	},
/turf/simulated/floor/tiled/white,
/area/medical/surgery)
"CJ" = (
/obj/floor_decal/corner/blue/diagonal,
/obj/machinery/atmospherics/pipe/manifold/visible/blue,
/obj/item/reagent_containers/glass/beaker/cryoxadone,
/turf/simulated/floor/tiled/white,
/area/medical/surgery)
"Dh" = (
/obj/floor_decal/corner/blue/diagonal,
/obj/machinery/botany/extractor,
/turf/simulated/floor/tiled/white,
/area/medical/surgery)
"DL" = (
/turf/simulated/wall,
/area/medical/surgery)
"Eb" = (
/obj/floor_decal/corner/blue/diagonal,
/obj/machinery/robotics_fabricator,
/turf/simulated/floor/tiled/white,
/area/medical/surgery)
"Eq" = (
/obj/floor_decal/corner/blue/diagonal,
/obj/structure/table/standard,
/obj/machinery/chemical_dispenser/bar_alc/full,
/turf/simulated/floor/tiled/white,
/area/medical/surgery)
"HE" = (
/obj/floor_decal/corner/blue/diagonal,
/turf/simulated/floor/tiled/white,
/area/medical/surgery)
"Ii" = (
/obj/floor_decal/corner/blue/diagonal{
	dir = 1
	},
/obj/machinery/computer/robotics{
	dir = 8
	},
/turf/simulated/floor/tiled/white,
/area/medical/surgery)
"KN" = (
/obj/floor_decal/corner/blue/diagonal,
/obj/structure/table/rack,
/obj/item/stack/material/plasteel/fifty,
/obj/item/stack/material/steel/fifty,
/obj/item/stack/material/glass/fifty,
/obj/item/stack/material/gold/ten,
/obj/item/stack/material/mhydrogen/ten,
/obj/item/stack/material/silver/ten,
/obj/item/stack/material/uranium/ten,
/obj/item/stack/material/diamond/ten,
/obj/item/stack/material/phoron/fifty,
/obj/item/storage/belt/utility/full,
/obj/item/stack/material/steel/fifty,
/turf/simulated/floor/tiled/white,
/area/medical/surgery)
"LV" = (
/obj/floor_decal/corner/blue/diagonal,
/obj/machinery/sleeper{
	dir = 8
	},
/turf/simulated/floor/tiled/white,
/area/medical/surgery)
"Mn" = (
/obj/floor_decal/corner/blue/diagonal,
/obj/machinery/organ_printer/robot/mapped,
/turf/simulated/floor/tiled/white,
/area/medical/surgery)
"Nd" = (
/obj/floor_decal/corner/blue/diagonal,
/obj/machinery/vending/dinnerware,
/turf/simulated/floor/tiled/white,
/area/medical/surgery)
"NH" = (
/obj/machinery/light,
/obj/floor_decal/corner/blue/diagonal,
/obj/machinery/r_n_d/server/robotics,
/turf/simulated/floor/tiled/white,
/area/medical/surgery)
"NM" = (
/obj/floor_decal/corner/blue/diagonal,
/obj/structure/table/standard,
/obj/machinery/chemical_dispenser/bar_coffee/full,
/turf/simulated/floor/tiled/white,
/area/medical/surgery)
"NP" = (
/obj/floor_decal/corner/blue/diagonal,
/obj/machinery/cooking/still,
/turf/simulated/floor/tiled/white,
/area/medical/surgery)
"OD" = (
/obj/floor_decal/corner/blue/diagonal,
/obj/machinery/organ_printer/flesh/mapped,
/turf/simulated/floor/tiled/white,
/area/medical/surgery)
"OQ" = (
/obj/floor_decal/corner/blue/diagonal,
/obj/structure/reagent_dispensers/watertank,
/obj/item/reagent_containers/glass/bucket,
/turf/simulated/floor/tiled/white,
/area/medical/surgery)
"QF" = (
/obj/structure/cable,
/obj/machinery/power/debug_items/infinite_generator,
/obj/floor_decal/corner/blue/diagonal,
/turf/simulated/floor/tiled/white,
/area/medical/surgery)
"QG" = (
/obj/floor_decal/corner/blue/diagonal,
/obj/machinery/atmospherics/unary/vent_pump/on,
/turf/simulated/floor/tiled/white,
/area/medical/surgery)
"QN" = (
/obj/floor_decal/corner/blue/diagonal,
/obj/machinery/reagentgrinder/juicer,
/obj/item/reagent_containers/glass/beaker/large,
/obj/structure/table/standard,
/turf/simulated/floor/tiled/white,
/area/medical/surgery)
"QY" = (
/obj/item/stock_parts/scanning_module,
/obj/item/stock_parts/manipulator,
/obj/item/stock_parts/manipulator,
/obj/item/reagent_containers/dropper{
	pixel_y = -4
	},
/obj/structure/closet/crate/plastic,
/obj/random/powercell,
/obj/random/powercell,
/obj/random/powercell,
/obj/random/powercell,
/obj/item/device/robotanalyzer,
/obj/item/organ/internal/posibrain,
/obj/item/organ/internal/posibrain,
/obj/item/organ/internal/posibrain,
/obj/item/aicard,
/obj/item/clothing/gloves/insulated,
/obj/item/clothing/gloves/insulated,
/obj/item/device/radio/headset/headset_eng,
/obj/item/device/radio/headset/headset_eng,
/obj/item/device/multitool{
	pixel_x = 3
	},
/obj/item/device/multitool{
	pixel_x = 3
	},
/obj/item/storage/belt/utility/full,
/obj/item/storage/belt/utility/full,
/obj/item/clothing/glasses/welding,
/obj/item/clothing/head/welding{
	pixel_x = -3;
	pixel_y = 5
	},
/obj/floor_decal/corner/blue/diagonal,
/obj/machinery/light{
	dir = 4;
	icon_state = "tube1"
	},
/turf/simulated/floor/tiled/white,
/area/medical/surgery)
"RG" = (
/obj/structure/lattice,
/turf/simulated/open,
/area/medical/surgery)
"RJ" = (
/obj/floor_decal/corner/blue/diagonal,
/obj/structure/table/rack,
/obj/item/stack/material/aluminium/fifty,
/obj/item/stack/material/glass/fifty,
/obj/item/stack/material/steel/fifty,
/obj/item/stack/material/plastic/fifty,
/obj/item/stack/material/phoron/fifty,
/obj/item/stack/material/silver/ten,
/obj/item/stack/material/gold/ten,
/obj/item/stack/material/diamond/ten,
/obj/item/stack/material/uranium/ten,
/obj/item/research,
/obj/item/reagent_containers/glass/beaker,
/turf/simulated/floor/tiled/white,
/area/medical/surgery)
"SL" = (
/obj/floor_decal/corner/blue/diagonal,
/obj/machinery/mech_recharger,
/turf/simulated/floor/tiled/white,
/area/medical/surgery)
"Tm" = (
/obj/floor_decal/corner/blue/diagonal,
/obj/machinery/bodyscanner{
	dir = 4
	},
/turf/simulated/floor/tiled/white,
/area/medical/surgery)
"Uq" = (
/obj/floor_decal/corner/blue/diagonal,
/obj/machinery/seed_extractor,
/turf/simulated/floor/tiled/white,
/area/medical/surgery)
"UD" = (
/obj/floor_decal/corner/blue/diagonal,
/obj/machinery/portable_atmospherics/canister/empty,
/obj/machinery/atmospherics/portables_connector{
	dir = 1
	},
/turf/simulated/floor/tiled/white,
/area/medical/surgery)
"VS" = (
/obj/floor_decal/corner/blue/diagonal,
/obj/item/reagent_containers/glass/beaker/large,
/obj/item/reagent_containers/glass/beaker/insulated/large,
/obj/item/reagent_containers/glass/beaker/noreact,
/obj/structure/table/rack,
/turf/simulated/floor/tiled/white,
/area/medical/surgery)
"Wk" = (
/obj/floor_decal/corner/blue/diagonal,
/obj/machinery/portable_atmospherics/canister/oxygen/prechilled,
/obj/machinery/atmospherics/portables_connector,
/turf/simulated/floor/tiled/white,
/area/medical/surgery)
"XF" = (
/obj/machinery/light_switch{
	pixel_x = 25
	},
/obj/floor_decal/corner/blue/diagonal,
/obj/machinery/portable_atmospherics/hydroponics,
/turf/simulated/floor/tiled/white,
/area/medical/surgery)
"XT" = (
/turf/simulated/open,
/area/medical/surgery)
"Ye" = (
/obj/floor_decal/corner/blue/diagonal,
/obj/machinery/atmospherics/unary/freezer,
/turf/simulated/floor/tiled/white,
/area/medical/surgery)
"Yr" = (
/obj/floor_decal/corner/blue/diagonal,
/obj/machinery/computer/rdconsole/robotics{
	dir = 1
	},
/turf/simulated/floor/tiled/white,
/area/medical/surgery)
"Yt" = (
/obj/floor_decal/corner/blue/diagonal,
/obj/machinery/atmospherics/pipe/simple/visible/blue{
	dir = 9
	},
/turf/simulated/floor/tiled/white,
/area/medical/surgery)
"YL" = (
/obj/floor_decal/corner/blue/diagonal,
/obj/structure/table/glass,
/obj/item/storage/firstaid/surgery,
/turf/simulated/floor/tiled/white,
/area/medical/surgery)
"Zl" = (
/obj/floor_decal/corner/blue/diagonal,
/obj/structure/table/standard,
/obj/machinery/fabricator/micro/bartender,
/turf/simulated/floor/tiled/white,
/area/medical/surgery)
"Zq" = (
/obj/floor_decal/corner/blue/diagonal,
/obj/structure/ladder/updown,
/turf/simulated/floor/tiled/white,
/area/medical/surgery)

(1,1,1) = {"
oP
oP
oP
oP
oP
oP
oP
oP
oP
oP
oP
oP
oP
oP
oP
oP
oP
oP
oP
oP
oP
oP
oP
oP
oP
oP
oP
oP
oP
oP
oP
oP
"}
(2,1,1) = {"
oP
oP
oP
oP
oP
oP
oP
oP
oP
oP
oP
oP
oP
oP
oP
oP
oP
oP
oP
oP
oP
oP
oP
oP
oP
oP
oP
oP
oP
oP
oP
oP
"}
(3,1,1) = {"
oP
oP
oP
oP
oP
oP
oP
oP
oP
oP
oP
oP
oP
oP
oP
oP
oP
oP
oP
oP
oP
oP
oP
oP
oP
oP
oP
oP
oP
oP
oP
oP
"}
(4,1,1) = {"
oP
oP
oP
oP
oP
oP
oP
oP
oP
oP
oP
oP
oP
oP
oP
oP
oP
oP
oP
oP
oP
oP
oP
oP
oP
oP
oP
oP
oP
oP
oP
oP
"}
(5,1,1) = {"
oP
oP
oP
oP
oP
oP
oP
oP
oP
oP
oP
oP
oP
oP
oP
oP
oP
oP
oP
oP
oP
oP
oP
oP
oP
oP
oP
oP
oP
oP
oP
oP
"}
(6,1,1) = {"
oP
oP
oP
oP
oP
oP
oP
oP
oP
oP
oP
oP
oP
oP
oP
oP
oP
oP
oP
oP
oP
oP
oP
oP
oP
oP
oP
oP
oP
oP
oP
oP
"}
(7,1,1) = {"
oP
oP
oP
oP
oP
oP
oP
oP
oP
oP
oP
oP
oP
oP
oP
oP
oP
oP
oP
oP
oP
oP
oP
oP
oP
oP
oP
oP
oP
oP
oP
oP
"}
(8,1,1) = {"
oP
oP
oP
oP
oP
oP
oP
oP
oP
oP
oP
oP
oP
oP
oP
oP
oP
oP
oP
oP
oP
oP
oP
oP
oP
oP
oP
oP
oP
oP
oP
oP
"}
(9,1,1) = {"
oP
oP
oP
oP
oP
oP
oP
oP
oP
oP
oP
oP
oP
oP
oP
oP
oP
oP
oP
oP
oP
oP
oP
oP
oP
oP
oP
oP
oP
oP
oP
oP
"}
(10,1,1) = {"
oP
oP
oP
oP
oP
oP
oP
oP
oP
oP
oP
oP
oP
oP
oP
oP
oP
oP
oP
oP
oP
oP
oP
oP
oP
oP
oP
oP
oP
oP
oP
oP
"}
(11,1,1) = {"
oP
oP
oP
oP
oP
oP
oP
oP
oP
oP
oP
oP
oP
oP
oP
oP
oP
oP
oP
oP
oP
oP
oP
oP
oP
oP
oP
oP
oP
oP
oP
oP
"}
(12,1,1) = {"
oP
oP
oP
oP
oP
oP
oP
oP
oP
oP
oP
oP
oP
oP
oP
oP
oP
oP
oP
oP
oP
oP
oP
oP
oP
oP
oP
oP
oP
oP
oP
oP
"}
(13,1,1) = {"
oP
oP
oP
oP
oP
oP
oP
oP
oP
oP
oP
oP
oP
oP
oP
oP
oP
oP
oP
oP
oP
oP
oP
oP
oP
oP
oP
oP
oP
oP
oP
oP
"}
(14,1,1) = {"
oP
oP
oP
oP
oP
oP
oP
oP
oP
qw
oP
oP
oP
oP
oP
oP
oP
oP
oP
oP
oP
oP
oP
oP
oP
oP
oP
oP
oP
oP
oP
oP
"}
(15,1,1) = {"
oP
oP
oP
oP
oP
oP
oP
oP
oP
oP
oP
oP
oP
oP
oP
oP
oP
oP
oP
oP
oP
oP
oP
oP
oP
oP
oP
oP
oP
oP
oP
oP
"}
(16,1,1) = {"
oP
oP
oP
oP
oP
oP
oP
oP
oP
oP
oP
oP
oP
oP
oP
oP
oP
oP
oP
oP
oP
oP
oP
oP
oP
oP
oP
oP
oP
oP
oP
oP
"}
(17,1,1) = {"
oP
oP
oP
oP
oP
oP
oP
oP
oP
oP
oP
oP
oP
oP
oP
oP
oP
oP
oP
oP
oP
oP
oP
oP
oP
oP
oP
oP
oP
oP
oP
oP
"}
(18,1,1) = {"
oP
oP
oP
oP
oP
oP
oP
oP
oP
DL
DL
DL
DL
DL
DL
DL
DL
DL
DL
DL
DL
DL
DL
DL
oP
oP
oP
oP
oP
oP
oP
oP
"}
(19,1,1) = {"
oP
oP
oP
oP
oP
oP
oP
oP
oP
DL
hK
YL
iN
lM
jM
OD
Mn
cv
so
at
hO
ns
QF
DL
oP
oP
oP
oP
oP
oP
oP
oP
"}
(20,1,1) = {"
oP
oP
oP
oP
oP
oP
oP
oP
oP
DL
ou
HE
ad
HE
HE
HE
HE
HE
HE
HE
HE
QG
oU
DL
oP
oP
oP
oP
oP
oP
oP
oP
"}
(21,1,1) = {"
oP
oP
oP
oP
oP
oP
oP
oP
oP
DL
uA
HE
Tm
HE
Eb
HE
KN
VS
nu
zp
HE
pD
UD
DL
oP
oP
oP
oP
oP
oP
oP
oP
"}
(22,1,1) = {"
oP
oP
oP
oP
oP
oP
oP
oP
oP
DL
uM
HE
HE
HE
HE
HE
HE
tn
qx
HE
HE
HE
gm
DL
oP
oP
oP
oP
oP
oP
oP
oP
"}
(23,1,1) = {"
oP
oP
oP
oP
oP
oP
oP
oP
oP
DL
oW
mQ
LV
Zq
HE
HE
HE
HE
HE
HE
Cr
HE
mZ
DL
oP
oP
oP
oP
oP
oP
oP
oP
"}
(24,1,1) = {"
oP
oP
oP
oP
oP
oP
oP
oP
oP
DL
HE
RG
XT
Ye
CE
HE
HE
HE
HE
HE
SL
HE
gO
DL
oP
oP
oP
oP
oP
oP
oP
oP
"}
(25,1,1) = {"
oP
oP
oP
oP
oP
oP
oP
oP
oP
DL
RG
RG
XT
ms
CJ
HE
xr
HE
HE
HE
qQ
HE
RJ
DL
oP
oP
oP
oP
oP
oP
oP
oP
"}
(26,1,1) = {"
oP
oP
oP
oP
oP
oP
oP
oP
oP
DL
OQ
RG
XT
Wk
Yt
Zl
HE
lQ
HE
HE
HE
HE
zN
DL
oP
oP
oP
oP
oP
oP
oP
oP
"}
(27,1,1) = {"
oP
oP
oP
oP
oP
oP
oP
oP
oP
DL
gM
HE
vD
Nd
HE
wF
HE
NM
HE
HE
kA
vL
HE
DL
oP
oP
oP
oP
oP
oP
oP
oP
"}
(28,1,1) = {"
oP
oP
oP
oP
oP
oP
oP
oP
oP
DL
uV
HE
xe
qA
HE
jM
HE
Eq
HE
HE
eP
Eb
NH
DL
oP
oP
oP
oP
oP
oP
oP
oP
"}
(29,1,1) = {"
oP
oP
oP
oP
oP
oP
oP
oP
oP
DL
jS
yq
nw
jo
HE
gk
HE
xA
HE
HE
HE
HE
Yr
DL
oP
oP
oP
oP
oP
oP
oP
oP
"}
(30,1,1) = {"
oP
oP
oP
oP
oP
oP
oP
oP
oP
DL
kL
HE
HE
HE
HE
HE
HE
HE
HE
HE
HE
HE
Cr
DL
oP
oP
oP
oP
oP
oP
oP
oP
"}
(31,1,1) = {"
oP
oP
oP
oP
oP
oP
oP
oP
oP
DL
xu
xu
XF
lf
Dh
QN
Uq
oy
NP
QY
Ii
iG
HE
DL
oP
oP
oP
oP
oP
oP
oP
oP
"}
(32,1,1) = {"
oP
oP
oP
oP
oP
oP
oP
oP
oP
DL
DL
DL
DL
DL
DL
DL
DL
DL
DL
DL
DL
DL
DL
DL
oP
oP
oP
oP
oP
oP
oP
oP
"}
(33,1,1) = {"
oP
oP
oP
oP
oP
oP
oP
oP
oP
oP
oP
oP
oP
oP
oP
oP
oP
oP
oP
oP
oP
oP
oP
oP
oP
oP
oP
oP
oP
oP
oP
oP
"}
(34,1,1) = {"
oP
oP
oP
oP
oP
oP
oP
oP
oP
oP
oP
oP
oP
oP
oP
oP
oP
oP
oP
oP
oP
oP
oP
oP
oP
oP
oP
oP
oP
oP
oP
oP
"}
(35,1,1) = {"
oP
oP
oP
oP
oP
oP
oP
oP
oP
oP
oP
oP
oP
oP
oP
oP
oP
oP
oP
oP
oP
oP
oP
oP
oP
oP
oP
oP
oP
oP
oP
oP
"}
(36,1,1) = {"
oP
oP
oP
oP
oP
oP
oP
oP
oP
oP
oP
oP
oP
oP
oP
oP
oP
oP
oP
oP
oP
oP
oP
oP
oP
oP
oP
oP
oP
oP
oP
oP
"}
(37,1,1) = {"
oP
oP
oP
oP
oP
oP
oP
oP
oP
oP
oP
oP
oP
oP
oP
oP
oP
oP
oP
oP
oP
oP
oP
oP
oP
oP
oP
oP
oP
oP
oP
oP
"}
(38,1,1) = {"
oP
oP
oP
oP
oP
oP
oP
oP
oP
oP
oP
oP
oP
oP
oP
oP
oP
oP
oP
oP
oP
oP
oP
oP
oP
oP
oP
oP
oP
oP
oP
oP
"}
(39,1,1) = {"
oP
oP
oP
oP
oP
oP
oP
oP
oP
oP
oP
oP
oP
oP
oP
oP
oP
oP
oP
oP
oP
oP
oP
oP
oP
oP
oP
oP
oP
oP
oP
oP
"}
(40,1,1) = {"
oP
oP
oP
oP
oP
oP
oP
oP
oP
oP
oP
oP
oP
oP
oP
oP
oP
oP
oP
oP
oP
oP
oP
oP
oP
oP
oP
oP
oP
oP
oP
oP
"}
(41,1,1) = {"
oP
oP
oP
oP
oP
oP
oP
oP
oP
oP
oP
oP
oP
oP
oP
oP
oP
oP
oP
oP
oP
oP
oP
oP
oP
oP
oP
oP
oP
oP
oP
oP
"}
(42,1,1) = {"
oP
oP
oP
oP
oP
oP
oP
oP
oP
oP
oP
oP
oP
oP
oP
oP
oP
oP
oP
oP
oP
oP
oP
oP
oP
oP
oP
oP
oP
oP
oP
oP
"}
(43,1,1) = {"
oP
oP
oP
oP
oP
oP
oP
oP
oP
oP
oP
oP
oP
oP
oP
oP
oP
oP
oP
oP
oP
oP
oP
oP
oP
oP
oP
oP
oP
oP
oP
oP
"}
(44,1,1) = {"
oP
oP
oP
oP
oP
oP
oP
oP
oP
oP
oP
oP
oP
oP
oP
oP
oP
oP
oP
oP
oP
oP
oP
oP
oP
oP
oP
oP
oP
oP
oP
oP
"}
(45,1,1) = {"
oP
oP
oP
oP
oP
oP
oP
oP
oP
oP
oP
oP
oP
oP
oP
oP
oP
oP
oP
oP
oP
oP
oP
oP
oP
oP
oP
oP
oP
oP
oP
oP
"}
(46,1,1) = {"
oP
oP
oP
oP
oP
oP
oP
oP
oP
oP
oP
oP
oP
oP
oP
oP
oP
oP
oP
oP
oP
oP
oP
oP
oP
oP
oP
oP
oP
oP
oP
oP
"}
(47,1,1) = {"
oP
oP
oP
oP
oP
oP
oP
oP
oP
oP
oP
oP
oP
oP
oP
oP
oP
oP
oP
oP
oP
oP
oP
oP
oP
oP
oP
oP
oP
oP
oP
oP
"}
(48,1,1) = {"
oP
oP
oP
oP
oP
oP
oP
oP
oP
oP
oP
oP
oP
oP
oP
oP
oP
oP
oP
oP
oP
oP
oP
oP
oP
oP
oP
oP
oP
oP
oP
oP
"}
