//MAP CONVERTED BY dmm2tgm.py THIS HEADER COMMENT PREVENTS RECONVERSION, DO NOT REMOVE
"ap" = (
/obj/effect/floor_decal/corner/blue/diagonal,
/obj/machinery/vending/containers,
/turf/simulated/floor/tiled,
/area/maintenance/fsmaint2)
"au" = (
/obj/effect/floor_decal/corner/blue/diagonal,
/obj/machinery/vending/urist/hatdispenser,
/turf/simulated/floor/tiled,
/area/maintenance/fsmaint2)
"aL" = (
/obj/effect/floor_decal/corner/blue/diagonal,
/obj/machinery/light{
	dir = 4;
	icon_state = "tube1"
	},
/turf/simulated/floor/tiled,
/area/maintenance/fsmaint2)
"aY" = (
/obj/effect/floor_decal/corner/blue/diagonal,
/obj/machinery/vending/engivend,
/turf/simulated/floor/tiled,
/area/maintenance/fsmaint2)
"bg" = (
/obj/effect/floor_decal/corner/blue/diagonal,
/obj/machinery/vending/antag,
/turf/simulated/floor/tiled,
/area/maintenance/fsmaint2)
"bX" = (
/obj/effect/floor_decal/corner/blue/diagonal,
/obj/machinery/vending/fashionvend,
/turf/simulated/floor/tiled,
/area/maintenance/fsmaint2)
"dc" = (
/obj/machinery/atmospherics/pipe/simple/visible{
	dir = 4
	},
/obj/effect/floor_decal/corner/blue/diagonal,
/turf/simulated/floor/tiled,
/area/maintenance/fsmaint2)
"dL" = (
/obj/effect/floor_decal/corner/blue/diagonal,
/obj/machinery/fabricator/replicator,
/turf/simulated/floor/tiled,
/area/maintenance/fsmaint2)
"ft" = (
/obj/effect/floor_decal/corner/blue/diagonal,
/obj/machinery/vending/robotics,
/turf/simulated/floor/tiled,
/area/maintenance/fsmaint2)
"gl" = (
/obj/effect/floor_decal/corner/blue/diagonal,
/obj/machinery/vending/magivend,
/turf/simulated/floor/tiled,
/area/maintenance/fsmaint2)
"hi" = (
/obj/machinery/atmospherics/unary/vent_pump/on,
/obj/effect/floor_decal/corner/blue/diagonal,
/turf/simulated/floor/tiled,
/area/maintenance/fsmaint2)
"hq" = (
/obj/effect/floor_decal/corner/blue/diagonal,
/obj/machinery/vending/cola,
/turf/simulated/floor/tiled,
/area/maintenance/fsmaint2)
"ir" = (
/obj/effect/floor_decal/corner/blue/diagonal,
/obj/structure/cable{
	d1 = 1;
	d2 = 2;
	icon_state = "1-2";
	pixel_y = 0
	},
/turf/simulated/floor/tiled,
/area/maintenance/fsmaint2)
"iu" = (
/obj/effect/floor_decal/corner/blue/diagonal,
/obj/machinery/vending/dinnerware,
/turf/simulated/floor/tiled,
/area/maintenance/fsmaint2)
"iF" = (
/obj/effect/floor_decal/corner/blue/diagonal,
/obj/machinery/floor_light/mapped_off{
	default_light_outer_range = 6;
	default_light_inner_range = 2
	},
/turf/simulated/floor/tiled,
/area/maintenance/fsmaint2)
"iM" = (
/obj/effect/floor_decal/corner/blue/diagonal,
/obj/machinery/vending/soda,
/turf/simulated/floor/tiled,
/area/maintenance/fsmaint2)
"ja" = (
/obj/effect/floor_decal/corner/blue/diagonal,
/obj/machinery/vending/cigarette,
/turf/simulated/floor/tiled,
/area/maintenance/fsmaint2)
"jq" = (
/obj/effect/floor_decal/corner/blue/diagonal,
/obj/machinery/vending/fitness,
/turf/simulated/floor/tiled,
/area/maintenance/fsmaint2)
"jw" = (
/obj/effect/floor_decal/corner/blue/diagonal,
/obj/machinery/vending/urist/dress,
/turf/simulated/floor/tiled,
/area/maintenance/fsmaint2)
"jU" = (
/obj/effect/floor_decal/corner/blue/diagonal,
/obj/structure/ladder,
/turf/simulated/floor/tiled,
/area/maintenance/fsmaint2)
"jV" = (
/obj/effect/floor_decal/corner/blue/diagonal,
/obj/machinery/atmospherics/pipe/simple/visible{
	dir = 5;
	icon_state = "intact"
	},
/turf/simulated/floor/tiled,
/area/maintenance/fsmaint2)
"kb" = (
/obj/machinery/light,
/obj/effect/floor_decal/corner/blue/diagonal,
/turf/simulated/floor/tiled,
/area/maintenance/fsmaint2)
"kB" = (
/obj/effect/floor_decal/corner/blue/diagonal,
/obj/machinery/vending/urist/nanotrasen,
/turf/simulated/floor/tiled,
/area/maintenance/fsmaint2)
"ma" = (
/obj/machinery/light_switch{
	pixel_x = 25
	},
/obj/effect/floor_decal/corner/blue/diagonal,
/turf/simulated/floor/tiled,
/area/maintenance/fsmaint2)
"mN" = (
/obj/effect/floor_decal/corner/blue/diagonal,
/obj/machinery/vending/hydronutrients/generic,
/turf/simulated/floor/tiled,
/area/maintenance/fsmaint2)
"nu" = (
/obj/effect/floor_decal/corner/blue/diagonal,
/obj/machinery/vending/sol,
/turf/simulated/floor/tiled,
/area/maintenance/fsmaint2)
"nO" = (
/obj/effect/floor_decal/corner/blue/diagonal,
/obj/machinery/vending/weeb,
/turf/simulated/floor/tiled,
/area/maintenance/fsmaint2)
"oV" = (
/obj/machinery/atmospherics/portables_connector{
	dir = 8
	},
/obj/machinery/portable_atmospherics/canister/air,
/obj/effect/floor_decal/corner/blue/diagonal,
/turf/simulated/floor/tiled,
/area/maintenance/fsmaint2)
"pn" = (
/obj/effect/floor_decal/corner/blue/diagonal,
/obj/machinery/vending/mredispenser,
/turf/simulated/floor/tiled,
/area/maintenance/fsmaint2)
"pv" = (
/obj/effect/floor_decal/corner/blue/diagonal,
/obj/machinery/vending/urist/autodrobe,
/turf/simulated/floor/tiled,
/area/maintenance/fsmaint2)
"pG" = (
/obj/effect/floor_decal/corner/blue/diagonal,
/obj/machinery/vending/snack,
/turf/simulated/floor/tiled,
/area/maintenance/fsmaint2)
"pO" = (
/obj/machinery/light{
	dir = 8;
	icon_state = "tube1"
	},
/obj/effect/floor_decal/corner/blue/diagonal,
/obj/machinery/vending/assist/antag,
/turf/simulated/floor/tiled,
/area/maintenance/fsmaint2)
"pQ" = (
/obj/effect/floor_decal/corner/blue/diagonal,
/obj/structure/table/standard,
/obj/item/device/multitool,
/obj/item/device/multitool,
/obj/item/device/multitool,
/obj/item/storage/belt/utility/full,
/obj/item/storage/belt/utility/full,
/obj/item/storage/belt/utility/full,
/turf/simulated/floor/tiled,
/area/maintenance/fsmaint2)
"rQ" = (
/obj/effect/floor_decal/corner/blue/diagonal,
/obj/machinery/vending/tool/adherent,
/turf/simulated/floor/tiled,
/area/maintenance/fsmaint2)
"sA" = (
/obj/machinery/door/airlock/external/bolted{
	frequency = 1379
	},
/turf/simulated/floor,
/area/maintenance/fsmaint2)
"sO" = (
/obj/effect/floor_decal/corner/blue/diagonal,
/obj/machinery/vending/wallmed2,
/turf/simulated/floor/tiled,
/area/maintenance/fsmaint2)
"tQ" = (
/turf/simulated/open,
/area/maintenance/fsmaint2)
"vu" = (
/obj/effect/floor_decal/corner/blue/diagonal,
/obj/machinery/vending/hydronutrients,
/turf/simulated/floor/tiled,
/area/maintenance/fsmaint2)
"vP" = (
/obj/machinery/atmospherics/pipe/simple/visible{
	dir = 5
	},
/obj/effect/floor_decal/corner/blue/diagonal,
/turf/simulated/floor/tiled,
/area/maintenance/fsmaint2)
"wr" = (
/obj/effect/floor_decal/corner/blue/diagonal,
/turf/simulated/floor/tiled,
/area/maintenance/fsmaint2)
"ws" = (
/obj/effect/floor_decal/corner/blue/diagonal,
/obj/machinery/vending/boozeomat,
/turf/simulated/floor/tiled,
/area/maintenance/fsmaint2)
"wV" = (
/obj/effect/floor_decal/corner/blue/diagonal,
/obj/machinery/vending/hydroseeds/generic,
/turf/simulated/floor/tiled,
/area/maintenance/fsmaint2)
"wW" = (
/obj/effect/floor_decal/corner/blue/diagonal,
/obj/structure/table/standard,
/obj/item/card/emag,
/obj/item/card/emag,
/obj/item/card/emag,
/turf/simulated/floor/tiled,
/area/maintenance/fsmaint2)
"xv" = (
/obj/effect/floor_decal/corner/blue/diagonal,
/obj/structure/table/standard,
/obj/item/storage/toolbox/syndicate,
/obj/item/storage/toolbox/syndicate,
/obj/item/storage/toolbox/syndicate,
/turf/simulated/floor/tiled,
/area/maintenance/fsmaint2)
"xC" = (
/obj/effect/floor_decal/corner/blue/diagonal,
/obj/machinery/vending/sovietsoda,
/turf/simulated/floor/tiled,
/area/maintenance/fsmaint2)
"yz" = (
/obj/effect/floor_decal/corner/blue/diagonal,
/obj/machinery/vending/urist/assaultammodispenser,
/turf/simulated/floor/tiled,
/area/maintenance/fsmaint2)
"zc" = (
/obj/effect/floor_decal/corner/blue/diagonal,
/obj/machinery/vending/generic,
/turf/simulated/floor/tiled,
/area/maintenance/fsmaint2)
"zg" = (
/obj/machinery/light{
	dir = 8;
	icon_state = "tube1"
	},
/obj/effect/floor_decal/corner/blue/diagonal,
/obj/machinery/vending/urist/coatdispenser,
/turf/simulated/floor/tiled,
/area/maintenance/fsmaint2)
"zh" = (
/obj/machinery/embedded_controller/radio/simple_docking_controller{
	id_tag = "upper_level_dock";
	pixel_x = 8;
	pixel_y = -25
	},
/turf/simulated/floor,
/area/maintenance/fsmaint2)
"Ay" = (
/obj/effect/floor_decal/corner/blue/diagonal,
/obj/machinery/power/apc{
	dir = 8;
	name = "west bump";
	pixel_x = -24
	},
/obj/structure/cable,
/turf/simulated/floor/tiled,
/area/maintenance/fsmaint2)
"Bc" = (
/obj/effect/landmark/map_data{
	height = 2
	},
/turf/space,
/area/space)
"BC" = (
/obj/effect/floor_decal/corner/blue/diagonal,
/obj/machinery/vending/urist/sustenance,
/turf/simulated/floor/tiled,
/area/maintenance/fsmaint2)
"Cc" = (
/obj/effect/floor_decal/corner/blue/diagonal,
/obj/machinery/vending/phoronresearch,
/turf/simulated/floor/tiled,
/area/maintenance/fsmaint2)
"Ck" = (
/obj/effect/floor_decal/corner/blue/diagonal,
/obj/machinery/atmospherics/unary/vent_scrubber/on,
/turf/simulated/floor/tiled,
/area/maintenance/fsmaint2)
"CK" = (
/obj/effect/floor_decal/corner/blue/diagonal,
/obj/machinery/vending/security,
/turf/simulated/floor/tiled,
/area/maintenance/fsmaint2)
"DQ" = (
/obj/effect/floor_decal/corner/blue/diagonal,
/obj/machinery/light_switch{
	pixel_x = -25
	},
/obj/machinery/vending/urist/beltdispenser,
/turf/simulated/floor/tiled,
/area/maintenance/fsmaint2)
"HL" = (
/obj/machinery/atmospherics/portables_connector{
	dir = 8
	},
/obj/machinery/portable_atmospherics/canister/empty,
/obj/effect/floor_decal/corner/blue/diagonal,
/turf/simulated/floor/tiled,
/area/maintenance/fsmaint2)
"Ie" = (
/obj/effect/floor_decal/corner/blue/diagonal,
/obj/machinery/vending/whitedragon,
/turf/simulated/floor/tiled,
/area/maintenance/fsmaint2)
"If" = (
/turf/simulated/wall,
/area/maintenance/fsmaint2)
"JU" = (
/obj/effect/floor_decal/corner/blue/diagonal,
/obj/machinery/vending/games,
/turf/simulated/floor/tiled,
/area/maintenance/fsmaint2)
"Ke" = (
/obj/effect/floor_decal/corner/blue/diagonal,
/obj/machinery/vending/snix,
/turf/simulated/floor/tiled,
/area/maintenance/fsmaint2)
"Ky" = (
/obj/effect/floor_decal/corner/blue/diagonal,
/obj/machinery/vending/hotfood,
/turf/simulated/floor/tiled,
/area/maintenance/fsmaint2)
"Lo" = (
/obj/effect/floor_decal/corner/blue/diagonal,
/obj/machinery/vending/urist/pantsdispenser,
/turf/simulated/floor/tiled,
/area/maintenance/fsmaint2)
"Lp" = (
/obj/effect/floor_decal/corner/blue/diagonal,
/obj/machinery/vending/urist/shoedispenser,
/turf/simulated/floor/tiled,
/area/maintenance/fsmaint2)
"Mu" = (
/obj/machinery/light{
	dir = 1
	},
/obj/effect/floor_decal/corner/blue/diagonal,
/turf/simulated/floor/tiled,
/area/maintenance/fsmaint2)
"PR" = (
/turf/simulated/floor,
/area/maintenance/fsmaint2)
"Rr" = (
/turf/space,
/area/space)
"SA" = (
/obj/structure/lattice,
/turf/simulated/open,
/area/maintenance/fsmaint2)
"Tc" = (
/obj/effect/floor_decal/corner/blue/diagonal,
/obj/machinery/vending/tool,
/turf/simulated/floor/tiled,
/area/maintenance/fsmaint2)
"Ug" = (
/obj/effect/floor_decal/corner/blue/diagonal,
/obj/machinery/vending/urist/suitdispenser,
/turf/simulated/floor/tiled,
/area/maintenance/fsmaint2)
"Ul" = (
/obj/effect/shuttle_landmark/upper_level,
/turf/space,
/area/space)
"UI" = (
/obj/effect/floor_decal/corner/blue/diagonal,
/obj/machinery/vending/engineering,
/turf/simulated/floor/tiled,
/area/maintenance/fsmaint2)
"UK" = (
/obj/machinery/light{
	dir = 4;
	icon_state = "tube1"
	},
/obj/effect/floor_decal/corner/blue/diagonal,
/obj/machinery/vending/wallmed1,
/turf/simulated/floor/tiled,
/area/maintenance/fsmaint2)
"Vo" = (
/obj/effect/floor_decal/corner/blue/diagonal,
/obj/machinery/vending/props,
/turf/simulated/floor/tiled,
/area/maintenance/fsmaint2)
"Ww" = (
/obj/effect/floor_decal/corner/blue/diagonal,
/obj/machinery/vending/medical,
/turf/simulated/floor/tiled,
/area/maintenance/fsmaint2)
"WK" = (
/obj/effect/floor_decal/corner/blue/diagonal,
/obj/machinery/vending/hydroseeds,
/turf/simulated/floor/tiled,
/area/maintenance/fsmaint2)
"Xd" = (
/obj/effect/floor_decal/corner/blue/diagonal,
/obj/machinery/power/debug_items/infinite_generator,
/obj/structure/cable{
	d2 = 2;
	icon_state = "0-2"
	},
/turf/simulated/floor/tiled,
/area/maintenance/fsmaint2)
"Ya" = (
/obj/effect/floor_decal/corner/blue/diagonal,
/obj/machinery/vending/urist/assaultclothingdispenser,
/turf/simulated/floor/tiled,
/area/maintenance/fsmaint2)
"YB" = (
/obj/effect/floor_decal/corner/blue/diagonal,
/obj/machinery/vending/coffee,
/turf/simulated/floor/tiled,
/area/maintenance/fsmaint2)
"Zy" = (
/obj/effect/floor_decal/corner/blue/diagonal,
/obj/machinery/vending/assist,
/turf/simulated/floor/tiled,
/area/maintenance/fsmaint2)
"ZN" = (
/obj/effect/floor_decal/corner/blue/diagonal,
/obj/machinery/vending/lavatory,
/turf/simulated/floor/tiled,
/area/maintenance/fsmaint2)

(1,1,1) = {"
Rr
Rr
Rr
Rr
Rr
Rr
Rr
Rr
Rr
Rr
Rr
Rr
Rr
Rr
Rr
Rr
Rr
Rr
Rr
Rr
Rr
Rr
Rr
Rr
Rr
Rr
Rr
Rr
Rr
Rr
Rr
Rr
"}
(2,1,1) = {"
Rr
Rr
Rr
Rr
Rr
Rr
Rr
Rr
Rr
Rr
Rr
Rr
Rr
Rr
Rr
Rr
Rr
Rr
Rr
Rr
Rr
Rr
Rr
Rr
Rr
Rr
Rr
Rr
Rr
Rr
Rr
Rr
"}
(3,1,1) = {"
Rr
Rr
Rr
Rr
Rr
Rr
Rr
Rr
Rr
Rr
Rr
Rr
Rr
Rr
Rr
Rr
Rr
Rr
Rr
Rr
Rr
Rr
Rr
Rr
Rr
Rr
Rr
Rr
Rr
Rr
Rr
Rr
"}
(4,1,1) = {"
Rr
Rr
Rr
Rr
Rr
Rr
Rr
Rr
Rr
Rr
Rr
Rr
Rr
Rr
Rr
Rr
Rr
Rr
Rr
Rr
Rr
Rr
Rr
Rr
Rr
Rr
Rr
Rr
Rr
Rr
Rr
Rr
"}
(5,1,1) = {"
Rr
Rr
Rr
Rr
Rr
Rr
Rr
Rr
Rr
Rr
Rr
Rr
Rr
Rr
Rr
Rr
Rr
Rr
Rr
Rr
Rr
Rr
Rr
Rr
Rr
Rr
Rr
Rr
Rr
Rr
Rr
Rr
"}
(6,1,1) = {"
Rr
Rr
Rr
Rr
Rr
Rr
Rr
Rr
Rr
Rr
Rr
Rr
Rr
Rr
Rr
Rr
Rr
Rr
Rr
Rr
Rr
Rr
Rr
Rr
Rr
Rr
Rr
Rr
Rr
Rr
Rr
Rr
"}
(7,1,1) = {"
Rr
Rr
Rr
Rr
Rr
Rr
Rr
Rr
Rr
Rr
Rr
Rr
Rr
Rr
Rr
Rr
Rr
Rr
Rr
Rr
Rr
Rr
Rr
Rr
Rr
Rr
Rr
Rr
Rr
Rr
Rr
Rr
"}
(8,1,1) = {"
Rr
Rr
Rr
Rr
Rr
Rr
Rr
Rr
Rr
Rr
Rr
Rr
Rr
Rr
Rr
Rr
Rr
Rr
Rr
Rr
Rr
Rr
Rr
Rr
Rr
Rr
Rr
Rr
Rr
Rr
Rr
Rr
"}
(9,1,1) = {"
Rr
Rr
Rr
Rr
Rr
Rr
Rr
Rr
Rr
Rr
Rr
Rr
Rr
Rr
Rr
Rr
Rr
Rr
Rr
Rr
Rr
Rr
Rr
Rr
Rr
Rr
Rr
Rr
Rr
Rr
Rr
Rr
"}
(10,1,1) = {"
Rr
Rr
Rr
Rr
Rr
Rr
Rr
Rr
Rr
Rr
Rr
Rr
Rr
Rr
Rr
Rr
Rr
Rr
Rr
Rr
Rr
Rr
Rr
Rr
Rr
Rr
Rr
Rr
Rr
Rr
Rr
Rr
"}
(11,1,1) = {"
Rr
Rr
Rr
Rr
Rr
Rr
Rr
Rr
Rr
Rr
Rr
Rr
Rr
Rr
Rr
Rr
Rr
Rr
Rr
Rr
Rr
Rr
Rr
Rr
Rr
Rr
Rr
Rr
Rr
Rr
Rr
Rr
"}
(12,1,1) = {"
Rr
Rr
Rr
Rr
Rr
Rr
Rr
Rr
Rr
Rr
Rr
Rr
Rr
Rr
Rr
Rr
Rr
Rr
Rr
Rr
Rr
Rr
Rr
Rr
Rr
Rr
Rr
Rr
Rr
Rr
Rr
Rr
"}
(13,1,1) = {"
Rr
Rr
Rr
Rr
Rr
Rr
Rr
Rr
Rr
Rr
Rr
Rr
Rr
Rr
Rr
Rr
Rr
Rr
Rr
Rr
Rr
Rr
Rr
Rr
Rr
Rr
Rr
Rr
Rr
Rr
Rr
Rr
"}
(14,1,1) = {"
Rr
Rr
Rr
Rr
Rr
Rr
Rr
Rr
Rr
Bc
Rr
Rr
Rr
Rr
Rr
Rr
Rr
Rr
Rr
Rr
Rr
Rr
Rr
Rr
Rr
Rr
Rr
Rr
Rr
Rr
Rr
Rr
"}
(15,1,1) = {"
Rr
Rr
Rr
Rr
Rr
Rr
Rr
Rr
Rr
Rr
Rr
Rr
Rr
Rr
Rr
Rr
Rr
Rr
Rr
Rr
Rr
Rr
Rr
Rr
Rr
Rr
Rr
Rr
Rr
Rr
Rr
Rr
"}
(16,1,1) = {"
Rr
Rr
Rr
Rr
Rr
Rr
Rr
Rr
Rr
Rr
Rr
Rr
Rr
Rr
Rr
Rr
Rr
Rr
Rr
Rr
Rr
Rr
Rr
Rr
Rr
Rr
Rr
Rr
Rr
Rr
Rr
Rr
"}
(17,1,1) = {"
Rr
Rr
Rr
Rr
Rr
Rr
Rr
Rr
Rr
Rr
Rr
Rr
Rr
Rr
Rr
Rr
Rr
Rr
Rr
Rr
Rr
Rr
Rr
Rr
Rr
Rr
Rr
Rr
Rr
Rr
Rr
Rr
"}
(18,1,1) = {"
Rr
Rr
Rr
Rr
Rr
Rr
Rr
Rr
Rr
If
If
If
If
If
If
If
If
If
If
If
If
If
If
If
Rr
Rr
Rr
Rr
Rr
Rr
Rr
Rr
"}
(19,1,1) = {"
Rr
Rr
Rr
Rr
Rr
Rr
Rr
Rr
Rr
If
Xd
ir
Ay
zg
DQ
wr
jw
ja
ws
pO
Zy
bg
pv
If
Rr
Rr
Rr
Rr
Rr
Rr
Rr
Rr
"}
(20,1,1) = {"
Rr
Rr
Rr
Rr
Rr
Rr
Rr
Rr
Rr
If
yz
wr
wr
Ug
au
wr
wr
wr
wr
wr
wr
wr
wr
If
Rr
Rr
Rr
Rr
Rr
Rr
Rr
Rr
"}
(21,1,1) = {"
Rr
Rr
Rr
Rr
Rr
Rr
Rr
Rr
Rr
If
Ya
wr
wr
Lo
Lp
wr
wr
aY
UI
iu
ap
hq
YB
If
Rr
Rr
Rr
Rr
Rr
Rr
Rr
Rr
"}
(22,1,1) = {"
Rr
Rr
Rr
Rr
Rr
Rr
Rr
Rr
Rr
If
Mu
wr
wr
wr
wr
wr
wr
wr
wr
wr
wr
wr
kb
If
Rr
Rr
Rr
Rr
Rr
Rr
Rr
Rr
"}
(23,1,1) = {"
Rr
Rr
Rr
Rr
Rr
Rr
Rr
Rr
Rr
If
wr
wr
wr
jU
wr
wr
wr
ZN
Ky
zc
JU
jq
bX
If
Rr
Rr
Rr
Rr
Rr
Rr
Rr
Rr
"}
(24,1,1) = {"
Rr
Rr
Rr
Rr
Rr
Rr
Rr
Rr
Rr
If
wr
SA
tQ
tQ
wW
wr
wr
wr
wr
wr
wr
wr
wr
If
Rr
Rr
Rr
Rr
Rr
Rr
Rr
Rr
"}
(25,1,1) = {"
Rr
Rr
Rr
Rr
Rr
Rr
Rr
Rr
Rr
If
SA
SA
tQ
tQ
xv
wr
iF
ft
Ww
wV
WK
mN
vu
If
Rr
Rr
Rr
Rr
Rr
Rr
Rr
Rr
"}
(26,1,1) = {"
Rr
Rr
Rr
Rr
Rr
Rr
Rr
Rr
Rr
If
wr
SA
tQ
tQ
pQ
wr
wr
wr
wr
wr
wr
wr
wr
If
Rr
Rr
Rr
Rr
Rr
Rr
Rr
Rr
"}
(27,1,1) = {"
Rr
Rr
Rr
Rr
Rr
Rr
Rr
Rr
Rr
If
wr
wr
wr
wr
wr
wr
wr
pG
CK
Vo
Cc
pn
gl
If
Rr
Rr
Rr
Rr
Rr
Rr
Rr
Rr
"}
(28,1,1) = {"
Rr
Rr
Rr
Rr
Rr
Rr
Rr
Rr
Rr
If
Mu
wr
wr
wr
wr
wr
wr
wr
wr
wr
wr
wr
kb
If
Rr
Rr
Rr
Rr
Rr
Rr
Rr
Rr
"}
(29,1,1) = {"
Rr
Rr
Rr
Rr
Rr
Rr
Rr
Rr
Rr
If
hi
vP
wr
wr
wr
wr
wr
rQ
Tc
xC
nu
iM
Ke
If
Rr
Rr
Rr
Rr
Rr
Rr
Rr
Rr
"}
(30,1,1) = {"
Rr
Rr
Rr
Rr
Rr
Rr
Rr
Rr
Rr
If
wr
dc
wr
wr
Ck
jV
wr
wr
wr
wr
wr
wr
wr
If
Rr
Rr
Rr
Rr
Rr
Rr
Rr
Rr
"}
(31,1,1) = {"
Rr
Rr
Rr
Rr
Rr
Rr
Rr
Rr
Rr
If
aL
oV
ma
wr
aL
HL
dL
kB
BC
UK
sO
Ie
nO
If
Rr
Rr
Rr
Rr
Rr
Rr
Rr
Rr
"}
(32,1,1) = {"
Rr
Rr
Rr
Rr
Rr
Rr
Rr
Rr
Rr
If
If
If
If
PR
If
If
If
If
If
If
If
If
If
If
Rr
Rr
Rr
Rr
Rr
Rr
Rr
Rr
"}
(33,1,1) = {"
Rr
Rr
Rr
Rr
Rr
Rr
Rr
Rr
Rr
Rr
Rr
Rr
If
PR
If
Rr
Rr
Rr
Rr
Rr
Rr
Rr
Rr
Rr
Rr
Rr
Rr
Rr
Rr
Rr
Rr
Rr
"}
(34,1,1) = {"
Rr
Rr
Rr
Rr
Rr
Rr
Rr
Rr
Rr
Rr
Rr
Rr
If
zh
If
Rr
Rr
Rr
Rr
Rr
Rr
Rr
Rr
Rr
Rr
Rr
Rr
Rr
Rr
Rr
Rr
Rr
"}
(35,1,1) = {"
Rr
Rr
Rr
Rr
Rr
Rr
Rr
Rr
Rr
Rr
Rr
Rr
If
sA
If
Rr
Rr
Rr
Rr
Rr
Rr
Rr
Rr
Rr
Rr
Rr
Rr
Rr
Rr
Rr
Rr
Rr
"}
(36,1,1) = {"
Rr
Rr
Rr
Rr
Rr
Rr
Rr
Rr
Rr
Rr
Rr
Rr
Rr
Rr
Rr
Rr
Rr
Rr
Rr
Rr
Rr
Rr
Rr
Rr
Rr
Rr
Rr
Rr
Rr
Rr
Rr
Rr
"}
(37,1,1) = {"
Rr
Rr
Rr
Rr
Rr
Rr
Rr
Rr
Rr
Rr
Rr
Rr
Ul
Rr
Rr
Rr
Rr
Rr
Rr
Rr
Rr
Rr
Rr
Rr
Rr
Rr
Rr
Rr
Rr
Rr
Rr
Rr
"}
(38,1,1) = {"
Rr
Rr
Rr
Rr
Rr
Rr
Rr
Rr
Rr
Rr
Rr
Rr
Rr
Rr
Rr
Rr
Rr
Rr
Rr
Rr
Rr
Rr
Rr
Rr
Rr
Rr
Rr
Rr
Rr
Rr
Rr
Rr
"}
(39,1,1) = {"
Rr
Rr
Rr
Rr
Rr
Rr
Rr
Rr
Rr
Rr
Rr
Rr
Rr
Rr
Rr
Rr
Rr
Rr
Rr
Rr
Rr
Rr
Rr
Rr
Rr
Rr
Rr
Rr
Rr
Rr
Rr
Rr
"}
(40,1,1) = {"
Rr
Rr
Rr
Rr
Rr
Rr
Rr
Rr
Rr
Rr
Rr
Rr
Rr
Rr
Rr
Rr
Rr
Rr
Rr
Rr
Rr
Rr
Rr
Rr
Rr
Rr
Rr
Rr
Rr
Rr
Rr
Rr
"}
(41,1,1) = {"
Rr
Rr
Rr
Rr
Rr
Rr
Rr
Rr
Rr
Rr
Rr
Rr
Rr
Rr
Rr
Rr
Rr
Rr
Rr
Rr
Rr
Rr
Rr
Rr
Rr
Rr
Rr
Rr
Rr
Rr
Rr
Rr
"}
(42,1,1) = {"
Rr
Rr
Rr
Rr
Rr
Rr
Rr
Rr
Rr
Rr
Rr
Rr
Rr
Rr
Rr
Rr
Rr
Rr
Rr
Rr
Rr
Rr
Rr
Rr
Rr
Rr
Rr
Rr
Rr
Rr
Rr
Rr
"}
(43,1,1) = {"
Rr
Rr
Rr
Rr
Rr
Rr
Rr
Rr
Rr
Rr
Rr
Rr
Rr
Rr
Rr
Rr
Rr
Rr
Rr
Rr
Rr
Rr
Rr
Rr
Rr
Rr
Rr
Rr
Rr
Rr
Rr
Rr
"}
(44,1,1) = {"
Rr
Rr
Rr
Rr
Rr
Rr
Rr
Rr
Rr
Rr
Rr
Rr
Rr
Rr
Rr
Rr
Rr
Rr
Rr
Rr
Rr
Rr
Rr
Rr
Rr
Rr
Rr
Rr
Rr
Rr
Rr
Rr
"}
(45,1,1) = {"
Rr
Rr
Rr
Rr
Rr
Rr
Rr
Rr
Rr
Rr
Rr
Rr
Rr
Rr
Rr
Rr
Rr
Rr
Rr
Rr
Rr
Rr
Rr
Rr
Rr
Rr
Rr
Rr
Rr
Rr
Rr
Rr
"}
(46,1,1) = {"
Rr
Rr
Rr
Rr
Rr
Rr
Rr
Rr
Rr
Rr
Rr
Rr
Rr
Rr
Rr
Rr
Rr
Rr
Rr
Rr
Rr
Rr
Rr
Rr
Rr
Rr
Rr
Rr
Rr
Rr
Rr
Rr
"}
(47,1,1) = {"
Rr
Rr
Rr
Rr
Rr
Rr
Rr
Rr
Rr
Rr
Rr
Rr
Rr
Rr
Rr
Rr
Rr
Rr
Rr
Rr
Rr
Rr
Rr
Rr
Rr
Rr
Rr
Rr
Rr
Rr
Rr
Rr
"}
(48,1,1) = {"
Rr
Rr
Rr
Rr
Rr
Rr
Rr
Rr
Rr
Rr
Rr
Rr
Rr
Rr
Rr
Rr
Rr
Rr
Rr
Rr
Rr
Rr
Rr
Rr
Rr
Rr
Rr
Rr
Rr
Rr
Rr
Rr
"}
