//MAP CONVERTED BY dmm2tgm.py THIS HEADER COMMENT PREVENTS RECONVERSION, DO NOT REMOVE
"aA" = (
/obj/machinery/telecomms/server/map_preset/example,
/turf/simulated/floor/tiled,
/area/constructionsite)
"bI" = (
/obj/machinery/embedded_controller/radio/simple_docking_controller{
	id_tag = "lower_level_dock";
	pixel_x = -8;
	pixel_y = -25
	},
/turf/simulated/floor,
/area/constructionsite)
"cg" = (
/obj/machinery/door/airlock/external,
/obj/airlock_helper/door/ext_door,
/turf/simulated/floor/tiled,
/area/constructionsite)
"dU" = (
/obj/machinery/telecomms/bus/map_preset/example,
/turf/simulated/floor/tiled,
/area/constructionsite)
"dY" = (
/obj/machinery/tele_pad,
/turf/simulated/floor/tiled,
/area/constructionsite)
"eZ" = (
/obj/machinery/light_switch{
	pixel_x = 25
	},
/turf/simulated/floor/tiled,
/area/constructionsite)
"fa" = (
/obj/structure/cable,
/obj/machinery/power/debug_items/infinite_generator,
/turf/simulated/floor/tiled,
/area/constructionsite)
"fz" = (
/obj/machinery/photocopier/faxmachine{
	department = "Test Fax 2"
	},
/turf/simulated/floor/tiled,
/area/constructionsite)
"fV" = (
/obj/machinery/light,
/obj/machinery/telecomms/processor/map_preset/example,
/turf/simulated/floor/tiled,
/area/constructionsite)
"gn" = (
/obj/machinery/atmospherics/pipe/manifold/visible{
	dir = 1
	},
/obj/machinery/airlock_sensor{
	pixel_y = 22
	},
/obj/airlock_helper/sensor/chamber_sensor{
	pixel_y = 22
	},
/turf/simulated/floor/tiled,
/area/constructionsite)
"gH" = (
/obj/structure/cable{
	d1 = 1;
	d2 = 2;
	icon_state = "1-2"
	},
/turf/simulated/floor/tiled,
/area/constructionsite)
"iy" = (
/obj/machinery/door/airlock/external/bolted{
	frequency = 1379;
	id_tag = "lower_level_dock_hatch"
	},
/turf/simulated/floor,
/area/constructionsite)
"iO" = (
/obj/machinery/atmospherics/unary/vent_scrubber/on{
	dir = 1
	},
/turf/simulated/floor/tiled,
/area/constructionsite)
"iV" = (
/obj/structure/bed/chair{
	dir = 1
	},
/obj/machinery/embedded_controller/radio/simple_docking_controller{
	id_tag = "example_shuttle_starboard";
	pixel_x = 28
	},
/obj/machinery/embedded_controller/radio/simple_docking_controller{
	id_tag = "example_shuttle_port";
	pixel_x = -28
	},
/obj/shuttle_landmark/lower_level,
/turf/simulated/floor/plating,
/area/shuttle/escape)
"jl" = (
/obj/machinery/door/airlock/external,
/obj/airlock_helper/door/int_door,
/turf/simulated/floor/tiled,
/area/constructionsite)
"kn" = (
/obj/machinery/atmospherics/pipe/simple/visible{
	dir = 10
	},
/obj/machinery/embedded_controller/radio/airlock/airlock_controller{
	pixel_y = 19;
	id_tag = "example_east"
	},
/turf/simulated/floor/tiled,
/area/constructionsite)
"lT" = (
/obj/machinery/telecomms/broadcaster/map_preset/example,
/turf/simulated/floor/tiled,
/area/constructionsite)
"mZ" = (
/turf/simulated/wall,
/area/constructionsite)
"nP" = (
/turf/simulated/wall/iron,
/area/shuttle/escape)
"oK" = (
/obj/machinery/atmospherics/pipe/simple/visible{
	dir = 6
	},
/turf/simulated/floor/tiled,
/area/constructionsite)
"pW" = (
/obj/machinery/atmospherics/portables_connector{
	dir = 8
	},
/obj/machinery/portable_atmospherics/canister/empty,
/turf/simulated/floor/tiled,
/area/constructionsite)
"qo" = (
/obj/landmark/start,
/turf/simulated/floor/tiled,
/area/constructionsite)
"rt" = (
/turf/simulated/floor,
/area/constructionsite)
"ru" = (
/turf/simulated/floor/carpet/black,
/area/constructionsite)
"sX" = (
/obj/machinery/light{
	dir = 1
	},
/turf/simulated/floor/tiled,
/area/constructionsite)
"tE" = (
/obj/machinery/door/airlock/external,
/obj/machinery/atmospherics/pipe/simple/visible{
	dir = 4
	},
/obj/airlock_helper/door/int_door,
/turf/simulated/floor/tiled,
/area/constructionsite)
"xL" = (
/turf/simulated/floor/tiled,
/area/constructionsite)
"yq" = (
/obj/machinery/computer/shuttle_control{
	shuttle_tag = "Example"
	},
/turf/simulated/floor/plating,
/area/shuttle/escape)
"zk" = (
/obj/machinery/telecomms/receiver/map_preset/example,
/turf/simulated/floor/tiled,
/area/constructionsite)
"zp" = (
/obj/machinery/door/airlock/external/bolted{
	frequency = 1379;
	id_tag = "example_shuttle_port_hatch"
	},
/turf/simulated/floor/plating,
/area/shuttle/escape)
"Bn" = (
/turf/simulated/floor/carpet,
/area/constructionsite)
"Ca" = (
/obj/machinery/telecomms/hub/map_preset/example,
/turf/simulated/floor/tiled,
/area/constructionsite)
"Co" = (
/turf/simulated/floor/carpet/blue2,
/area/constructionsite)
"CE" = (
/obj/machinery/tele_projector,
/turf/simulated/floor/tiled,
/area/constructionsite)
"Di" = (
/obj/machinery/light{
	dir = 8;
	icon_state = "tube1"
	},
/turf/simulated/floor/tiled,
/area/constructionsite)
"DI" = (
/turf/simulated/floor/carpet/blue,
/area/constructionsite)
"Ed" = (
/obj/machinery/light{
	dir = 4;
	icon_state = "tube1"
	},
/obj/machinery/atmospherics/portables_connector,
/obj/machinery/portable_atmospherics/canister/air,
/turf/simulated/floor/tiled,
/area/constructionsite)
"ER" = (
/obj/machinery/access_button{
	pixel_x = -22;
	pixel_y = 22
	},
/obj/airlock_helper/button/exterior{
	pixel_x = -22
	},
/turf/space,
/area/space)
"Fs" = (
/obj/machinery/computer/teleporter,
/turf/simulated/floor/tiled,
/area/constructionsite)
"Hn" = (
/obj/machinery/photocopier/faxmachine{
	department = "Test Fax 1"
	},
/turf/simulated/floor/tiled,
/area/constructionsite)
"HH" = (
/obj/machinery/light_switch{
	pixel_x = -25
	},
/turf/simulated/floor/tiled,
/area/constructionsite)
"Jw" = (
/obj/landmark/test/space_turf,
/turf/space,
/area/space)
"JM" = (
/obj/floor_decal/industrial/hatch/yellow,
/turf/simulated/floor/tiled,
/area/constructionsite)
"JR" = (
/obj/machinery/light,
/turf/simulated/floor/plating,
/area/shuttle/escape)
"Kr" = (
/obj/wingrille_spawn/reinforced,
/turf/simulated/floor/plating,
/area/shuttle/escape)
"KI" = (
/obj/machinery/light,
/turf/simulated/floor/tiled,
/area/constructionsite)
"KV" = (
/obj/machinery/atmospherics/pipe/simple/visible{
	dir = 4
	},
/turf/simulated/floor/tiled,
/area/constructionsite)
"Lb" = (
/obj/machinery/tele_beacon,
/turf/simulated/floor/tiled,
/area/constructionsite)
"LQ" = (
/obj/structure/ladder/up,
/turf/simulated/floor/tiled,
/area/constructionsite)
"LS" = (
/obj/machinery/atmospherics/unary/vent_pump/on,
/turf/simulated/floor/tiled,
/area/constructionsite)
"Mn" = (
/obj/machinery/atmospherics/portables_connector{
	dir = 8
	},
/obj/machinery/portable_atmospherics/canister/air,
/turf/simulated/floor/tiled,
/area/constructionsite)
"OC" = (
/turf/space,
/area/space)
"OH" = (
/obj/machinery/atmospherics/pipe/simple/visible{
	dir = 5
	},
/turf/simulated/floor/tiled,
/area/constructionsite)
"OO" = (
/obj/landmark/test/safe_turf,
/turf/simulated/floor/tiled,
/area/constructionsite)
"PQ" = (
/obj/machinery/access_button{
	pixel_x = 22;
	pixel_y = -22
	},
/obj/airlock_helper/button/interior{
	pixel_y = -22
	},
/turf/simulated/floor/tiled,
/area/constructionsite)
"Qu" = (
/obj/machinery/light{
	dir = 4;
	icon_state = "tube1"
	},
/turf/simulated/floor/tiled,
/area/constructionsite)
"Rc" = (
/obj/landmark{
	name = "JoinLate"
	},
/turf/simulated/floor/tiled,
/area/constructionsite)
"Rv" = (
/obj/machinery/door/airlock/external/bolted{
	frequency = 1379;
	id_tag = "example_shuttle_starboard_hatch"
	},
/turf/simulated/floor/plating,
/area/shuttle/escape)
"ST" = (
/obj/structure/cable{
	d2 = 2;
	icon_state = "0-2"
	},
/obj/machinery/power/apc{
	dir = 8;
	name = "west bump";
	pixel_x = -24
	},
/turf/simulated/floor/tiled,
/area/constructionsite)
"WM" = (
/turf/simulated/floor/carpet/blue3,
/area/constructionsite)
"Xg" = (
/obj/landmark{
	name = "tdome1"
	},
/turf/simulated/floor/tiled,
/area/constructionsite)
"XH" = (
/obj/airlock_helper/atmos/chamber_pump,
/obj/machinery/atmospherics/unary/vent_pump/high_volume/airlock{
	dir = 1
	},
/obj/machinery/light/small,
/turf/simulated/floor/tiled,
/area/constructionsite)
"Zx" = (
/obj/airlock_helper/atmos/chamber_pump,
/obj/machinery/atmospherics/unary/vent_pump/high_volume/airlock{
	dir = 1
	},
/turf/simulated/floor/tiled,
/area/constructionsite)

(1,1,1) = {"
OC
OC
OC
OC
OC
OC
OC
OC
OC
OC
OC
OC
OC
OC
OC
OC
OC
OC
OC
OC
OC
OC
OC
OC
OC
OC
OC
OC
OC
OC
OC
OC
"}
(2,1,1) = {"
OC
OC
OC
OC
OC
OC
OC
OC
OC
OC
OC
OC
OC
OC
OC
OC
OC
OC
OC
OC
OC
OC
OC
OC
OC
OC
OC
OC
OC
OC
OC
OC
"}
(3,1,1) = {"
OC
OC
OC
OC
OC
OC
OC
OC
OC
OC
OC
OC
OC
OC
OC
OC
OC
OC
OC
OC
OC
OC
OC
OC
OC
OC
OC
OC
OC
OC
OC
OC
"}
(4,1,1) = {"
OC
OC
OC
OC
OC
OC
OC
OC
OC
OC
OC
OC
OC
OC
OC
OC
OC
OC
OC
OC
OC
OC
OC
OC
OC
OC
OC
OC
OC
OC
OC
OC
"}
(5,1,1) = {"
OC
OC
OC
OC
OC
OC
OC
OC
OC
OC
OC
OC
OC
OC
OC
OC
OC
OC
OC
OC
OC
OC
OC
OC
OC
OC
OC
OC
OC
OC
OC
OC
"}
(6,1,1) = {"
OC
OC
OC
OC
OC
OC
OC
OC
OC
OC
OC
OC
OC
OC
OC
OC
OC
OC
OC
OC
OC
OC
OC
OC
OC
OC
OC
OC
OC
OC
OC
OC
"}
(7,1,1) = {"
OC
OC
OC
OC
OC
OC
OC
OC
OC
OC
OC
OC
OC
OC
OC
OC
OC
OC
OC
OC
OC
OC
OC
OC
OC
OC
OC
OC
OC
OC
OC
OC
"}
(8,1,1) = {"
OC
OC
OC
OC
OC
OC
OC
OC
OC
OC
OC
OC
OC
OC
OC
OC
OC
OC
OC
OC
OC
OC
OC
OC
OC
OC
OC
OC
OC
OC
OC
OC
"}
(9,1,1) = {"
OC
OC
OC
OC
OC
OC
OC
OC
OC
OC
OC
OC
OC
OC
OC
OC
OC
OC
OC
OC
OC
OC
OC
OC
OC
OC
OC
OC
OC
OC
OC
OC
"}
(10,1,1) = {"
OC
OC
OC
OC
OC
OC
OC
OC
OC
OC
OC
OC
OC
OC
OC
OC
OC
OC
OC
OC
OC
OC
OC
OC
OC
OC
OC
OC
OC
OC
OC
OC
"}
(11,1,1) = {"
OC
OC
OC
OC
OC
OC
OC
OC
OC
OC
OC
OC
OC
OC
OC
OC
OC
OC
OC
OC
OC
OC
OC
OC
OC
OC
OC
OC
OC
OC
OC
OC
"}
(12,1,1) = {"
OC
OC
OC
OC
OC
OC
OC
OC
OC
OC
OC
OC
OC
OC
OC
OC
OC
OC
OC
OC
OC
OC
OC
OC
OC
OC
OC
OC
OC
OC
OC
OC
"}
(13,1,1) = {"
OC
OC
OC
OC
OC
OC
OC
OC
OC
OC
OC
OC
OC
OC
OC
nP
Kr
Kr
zp
nP
OC
OC
OC
OC
OC
OC
OC
OC
OC
OC
OC
OC
"}
(14,1,1) = {"
OC
OC
OC
OC
OC
OC
OC
OC
OC
OC
OC
OC
OC
OC
OC
nP
yq
iV
JR
nP
OC
OC
OC
OC
OC
OC
OC
OC
OC
OC
OC
OC
"}
(15,1,1) = {"
OC
OC
OC
OC
OC
OC
OC
OC
OC
OC
OC
OC
OC
OC
OC
nP
Kr
Kr
Rv
nP
OC
OC
OC
OC
OC
OC
OC
OC
OC
OC
OC
OC
"}
(16,1,1) = {"
OC
OC
OC
OC
OC
OC
OC
OC
OC
OC
OC
OC
OC
OC
OC
OC
OC
mZ
iy
mZ
OC
OC
OC
OC
OC
OC
OC
OC
OC
OC
OC
OC
"}
(17,1,1) = {"
OC
OC
OC
OC
OC
OC
OC
OC
OC
OC
OC
OC
OC
OC
OC
OC
OC
mZ
bI
mZ
OC
OC
OC
OC
OC
OC
OC
OC
OC
OC
OC
OC
"}
(18,1,1) = {"
OC
OC
OC
OC
OC
OC
OC
OC
OC
mZ
mZ
mZ
mZ
mZ
mZ
mZ
mZ
mZ
rt
mZ
mZ
mZ
mZ
mZ
OC
OC
OC
OC
OC
OC
OC
OC
"}
(19,1,1) = {"
OC
OC
OC
OC
OC
OC
OC
OC
OC
mZ
DI
Co
WM
Di
xL
xL
HH
xL
xL
Di
ST
gH
fa
mZ
OC
OC
OC
OC
OC
OC
OC
OC
"}
(20,1,1) = {"
OC
OC
OC
OC
OC
OC
OC
OC
OC
mZ
ru
Xg
Xg
Xg
xL
xL
xL
xL
xL
xL
xL
xL
xL
mZ
OC
OC
OC
OC
OC
OC
OC
OC
"}
(21,1,1) = {"
OC
OC
OC
OC
OC
OC
OC
OC
OC
mZ
Bn
Xg
Xg
Xg
xL
xL
xL
xL
xL
Rc
Rc
Rc
xL
mZ
OC
OC
OC
OC
OC
OC
OC
OC
"}
(22,1,1) = {"
OC
OC
OC
OC
OC
OC
OC
OC
OC
mZ
sX
Xg
Xg
Xg
xL
xL
xL
xL
xL
Rc
Rc
Rc
KI
mZ
OC
OC
OC
OC
OC
OC
OC
OC
"}
(23,1,1) = {"
OC
OC
OC
OC
OC
OC
OC
OC
OC
mZ
xL
xL
xL
LQ
xL
xL
xL
OO
xL
Rc
Rc
Rc
Hn
mZ
OC
OC
Jw
OC
OC
OC
OC
OC
"}
(24,1,1) = {"
OC
OC
OC
OC
OC
OC
OC
OC
OC
mZ
xL
JM
JM
JM
xL
xL
xL
xL
xL
xL
xL
xL
xL
mZ
OC
OC
OC
OC
OC
OC
OC
OC
"}
(25,1,1) = {"
OC
OC
OC
OC
OC
OC
OC
OC
OC
mZ
xL
mZ
JM
JM
xL
xL
qo
xL
xL
xL
xL
xL
fz
mZ
OC
OC
OC
OC
OC
OC
OC
OC
"}
(26,1,1) = {"
OC
OC
OC
OC
OC
OC
OC
OC
OC
mZ
xL
JM
JM
JM
xL
xL
xL
xL
xL
xL
xL
xL
zk
mZ
OC
OC
OC
OC
OC
OC
OC
OC
"}
(27,1,1) = {"
OC
OC
OC
OC
OC
OC
OC
OC
OC
mZ
xL
xL
xL
xL
xL
xL
xL
xL
xL
xL
xL
xL
aA
mZ
OC
OC
OC
OC
OC
OC
OC
OC
"}
(28,1,1) = {"
OC
OC
OC
OC
OC
OC
OC
OC
OC
mZ
sX
xL
xL
xL
xL
xL
xL
xL
xL
xL
xL
xL
fV
mZ
OC
OC
OC
OC
OC
OC
OC
OC
"}
(29,1,1) = {"
OC
OC
OC
OC
OC
OC
OC
OC
OC
mZ
Fs
xL
xL
xL
LS
OH
xL
oK
iO
xL
xL
xL
dU
mZ
OC
OC
OC
OC
OC
OC
OC
OC
"}
(30,1,1) = {"
OC
OC
OC
OC
OC
OC
OC
OC
OC
mZ
CE
xL
xL
Lb
xL
KV
xL
KV
xL
xL
xL
xL
Ca
mZ
OC
OC
OC
OC
OC
OC
OC
OC
"}
(31,1,1) = {"
OC
OC
OC
OC
OC
OC
OC
OC
OC
mZ
dY
xL
eZ
Qu
xL
Mn
xL
pW
xL
Ed
OH
PQ
lT
mZ
OC
OC
OC
OC
OC
OC
OC
OC
"}
(32,1,1) = {"
OC
OC
OC
OC
OC
OC
OC
OC
OC
mZ
mZ
mZ
mZ
mZ
mZ
mZ
mZ
mZ
mZ
mZ
tE
jl
mZ
mZ
OC
OC
OC
OC
OC
OC
OC
OC
"}
(33,1,1) = {"
OC
OC
OC
OC
OC
OC
OC
OC
OC
OC
OC
OC
OC
OC
OC
OC
OC
OC
OC
mZ
gn
Zx
mZ
OC
OC
OC
OC
OC
OC
OC
OC
OC
"}
(34,1,1) = {"
OC
OC
OC
OC
OC
OC
OC
OC
OC
OC
OC
OC
OC
OC
OC
OC
OC
OC
OC
mZ
kn
XH
mZ
OC
OC
OC
OC
OC
OC
OC
OC
OC
"}
(35,1,1) = {"
OC
OC
OC
OC
OC
OC
OC
OC
OC
OC
OC
OC
OC
OC
OC
OC
OC
OC
OC
mZ
cg
cg
mZ
OC
OC
OC
OC
OC
OC
OC
OC
OC
"}
(36,1,1) = {"
OC
OC
OC
OC
OC
OC
OC
OC
OC
OC
OC
OC
OC
OC
OC
OC
OC
OC
OC
OC
ER
OC
OC
OC
OC
OC
OC
OC
OC
OC
OC
OC
"}
(37,1,1) = {"
OC
OC
OC
OC
OC
OC
OC
OC
OC
OC
OC
OC
OC
OC
OC
OC
OC
OC
OC
OC
OC
OC
OC
OC
OC
OC
OC
OC
OC
OC
OC
OC
"}
(38,1,1) = {"
OC
OC
OC
OC
OC
OC
OC
OC
OC
OC
OC
OC
OC
OC
OC
OC
OC
OC
OC
OC
OC
OC
OC
OC
OC
OC
OC
OC
OC
OC
OC
OC
"}
(39,1,1) = {"
OC
OC
OC
OC
OC
OC
OC
OC
OC
OC
OC
OC
OC
OC
OC
OC
OC
OC
OC
OC
OC
OC
OC
OC
OC
OC
OC
OC
OC
OC
OC
OC
"}
(40,1,1) = {"
OC
OC
OC
OC
OC
OC
OC
OC
OC
OC
OC
OC
OC
OC
OC
OC
OC
OC
OC
OC
OC
OC
OC
OC
OC
OC
OC
OC
OC
OC
OC
OC
"}
(41,1,1) = {"
OC
OC
OC
OC
OC
OC
OC
OC
OC
OC
OC
OC
OC
OC
OC
OC
OC
OC
OC
OC
OC
OC
OC
OC
OC
OC
OC
OC
OC
OC
OC
OC
"}
(42,1,1) = {"
OC
OC
OC
OC
OC
OC
OC
OC
OC
OC
OC
OC
OC
OC
OC
OC
OC
OC
OC
OC
OC
OC
OC
OC
OC
OC
OC
OC
OC
OC
OC
OC
"}
(43,1,1) = {"
OC
OC
OC
OC
OC
OC
OC
OC
OC
OC
OC
OC
OC
OC
OC
OC
OC
OC
OC
OC
OC
OC
OC
OC
OC
OC
OC
OC
OC
OC
OC
OC
"}
(44,1,1) = {"
OC
OC
OC
OC
OC
OC
OC
OC
OC
OC
OC
OC
OC
OC
OC
OC
OC
OC
OC
OC
OC
OC
OC
OC
OC
OC
OC
OC
OC
OC
OC
OC
"}
(45,1,1) = {"
OC
OC
OC
OC
OC
OC
OC
OC
OC
OC
OC
OC
OC
OC
OC
OC
OC
OC
OC
OC
OC
OC
OC
OC
OC
OC
OC
OC
OC
OC
OC
OC
"}
(46,1,1) = {"
OC
OC
OC
OC
OC
OC
OC
OC
OC
OC
OC
OC
OC
OC
OC
OC
OC
OC
OC
OC
OC
OC
OC
OC
OC
OC
OC
OC
OC
OC
OC
OC
"}
(47,1,1) = {"
OC
OC
OC
OC
OC
OC
OC
OC
OC
OC
OC
OC
OC
OC
OC
OC
OC
OC
OC
OC
OC
OC
OC
OC
OC
OC
OC
OC
OC
OC
OC
OC
"}
(48,1,1) = {"
OC
OC
OC
OC
OC
OC
OC
OC
OC
OC
OC
OC
OC
OC
OC
OC
OC
OC
OC
OC
OC
OC
OC
OC
OC
OC
OC
OC
OC
OC
OC
OC
"}
