//MAP CONVERTED BY dmm2tgm.py THIS HEADER COMMENT PREVENTS RECONVERSION, DO NOT REMOVE
"a" = (
/turf/template_noop,
/area/template_noop)
"b" = (
/obj/structure/closet/crate,
/turf/template_noop,
/area/template_noop)
"c" = (
/obj/structure/largecrate,
/turf/template_noop,
/area/template_noop)
"d" = (
/obj/structure/largecrate,
/obj/urist_intangible/mapmanip/marker/submap/extract/nerva/cargo_storage,
/turf/template_noop,
/area/template_noop)
"e" = (
/obj/urist_intangible/mapmanip/marker/submap/extract/nerva/cargo_storage,
/turf/template_noop,
/area/template_noop)
"f" = (
/obj/structure/reagent_dispensers/watertank,
/turf/template_noop,
/area/template_noop)
"g" = (
/obj/structure/closet/crate,
/obj/urist_intangible/mapmanip/marker/submap/extract/nerva/cargo_storage,
/turf/template_noop,
/area/template_noop)

(1,1,1) = {"
a
a
a
a
a
a
a
a
a
a
a
a
a
a
a
"}
(2,1,1) = {"
a
a
d
a
a
a
a
e
a
a
a
a
a
a
a
"}
(3,1,1) = {"
a
b
a
a
a
a
f
a
a
a
a
a
a
a
a
"}
(4,1,1) = {"
a
a
a
a
a
a
a
a
a
a
a
a
a
a
a
"}
(5,1,1) = {"
a
a
a
a
a
a
a
a
a
a
a
a
a
a
a
"}
(6,1,1) = {"
a
a
a
a
a
a
a
a
a
a
a
a
a
a
a
"}
(7,1,1) = {"
a
c
e
a
a
a
a
g
a
a
a
a
a
a
a
"}
(8,1,1) = {"
a
a
a
a
a
a
a
a
a
a
a
a
a
a
a
"}
(9,1,1) = {"
a
a
a
a
a
a
a
a
a
a
a
a
a
a
a
"}
(10,1,1) = {"
a
a
a
a
a
a
a
a
a
a
a
a
a
a
a
"}
(11,1,1) = {"
a
a
a
a
a
a
a
a
a
a
a
a
a
a
a
"}
(12,1,1) = {"
a
a
a
a
a
a
a
a
a
a
a
a
a
a
a
"}
(13,1,1) = {"
a
a
a
a
a
a
a
a
a
a
a
a
a
a
a
"}
(14,1,1) = {"
a
a
a
a
a
a
a
a
a
a
a
a
a
a
a
"}
(15,1,1) = {"
a
a
a
a
a
a
a
a
a
a
a
a
a
a
a
"}
