"a" = (/turf/space,/area/planet/forest/upper)
"b" = (/turf/simulated/floor/planet/jungle/rock,/area/planet/forest/upper)
"c" = (/turf/simulated/open,/area/planet/forest/upper)
"d" = (/turf/simulated/floor,/area/planet/forest/cabin2/attic)
"e" = (/turf/simulated/wall/wood,/area/planet/forest/cabin1/attic)
"f" = (/obj/effect/wingrille_spawn/reinforced/full,/turf/simulated/floor/wood,/area/planet/forest/cabin1/attic)
"g" = (/turf/simulated/floor/wood,/area/planet/forest/cabin1/attic)
"h" = (/turf/simulated/floor/wood{tag = "icon-wood_broken5"; icon_state = "wood_broken5"},/area/planet/forest/cabin1/attic)
"i" = (/turf/simulated/floor/wood{tag = "icon-wood_broken1"; icon_state = "wood_broken1"},/area/planet/forest/cabin1/attic)
"j" = (/turf/simulated/floor/wood{tag = "icon-wood_broken6"; icon_state = "wood_broken6"},/area/planet/forest/cabin1/attic)
"k" = (/obj/effect/landmark/map_data{height = 3},/turf/space,/area/planet/forest/upper)
"l" = (/obj/structure/ladder,/turf/simulated/floor/planet/jungle/clear/underground,/area/planet/forest/upper)
"m" = (/turf/simulated/mineral/random{mined_turf = /turf/simulated/floor/planet/jungle/clear/underground},/area/planet/forest/upper)
"n" = (/obj/structure/bed,/obj/effect/submap_landmark/joinable_submap/caraway_forest,/turf/simulated/floor/wood,/area/planet/forest/cabin1/attic)
"o" = (/turf/simulated/open/skylight,/area/planet/forest/cabin1/attic)
"p" = (/obj/item/remains/human,/turf/simulated/floor/planet/jungle/clear/underground,/area/planet/forest/upper)
"q" = (/obj/structure/closet,/obj/random/accessory,/obj/random/clothing,/obj/random/clothing,/obj/random/handgun,/obj/random/ammo,/obj/random/ammo,/obj/item/clothing/suit/urist/sweater/blue/heart,/turf/simulated/floor/wood,/area/planet/forest/cabin1/attic)
"t" = (/turf/simulated/open/skylight,/area/planet/forest/cabin2/attic)
"u" = (/obj/structure/bed/roller/ironingboard,/turf/simulated/floor/wood{tag = "icon-wood_broken5"; icon_state = "wood_broken5"},/area/planet/forest/cabin1/attic)
"v" = (/turf/simulated/open/skylight,/area/planet/forest/upper)
"w" = (/obj/structure/table/rack/wood,/obj/item/weapon/reagent_containers/spray/sterilizine,/obj/item/weapon/material/knife,/obj/item/stack/cable_coil/blue,/obj/item/weapon/crowbar/red,/obj/item/weapon/storage/fancy/cigarettes/killthroat,/obj/item/weapon/flame/lighter/cyan,/obj/item/weapon/material/hatchet,/obj/item/weapon/tape_roll,/obj/item/weapon/wrench,/obj/item/weapon/reagent_containers/glass/beaker/painkiller,/obj/item/weapon/reagent_containers/glass/beaker/painkiller,/obj/item/weapon/reagent_containers/pill/peridaxon,/obj/item/weapon/reagent_containers/pill/peridaxon,/obj/item/weapon/reagent_containers/pill/peridaxon,/turf/simulated/floor/wood,/area/planet/forest/cabin1/attic)
"y" = (/obj/effect/spider/stickyweb,/turf/simulated/floor/planet/jungle/clear/underground,/area/planet/forest/upper)
"z" = (/turf/simulated/mineral/random,/area/planet/forest/upper)
"A" = (/obj/structure/bed,/obj/effect/submap_landmark/spawnpoint/forest_settler,/turf/simulated/floor/wood,/area/planet/forest/cabin1/attic)
"E" = (/obj/structure/table/rack/wood,/obj/item/weapon/storage/firstaid/adv,/obj/item/weapon/storage/firstaid,/obj/item/weapon/storage/firstaid/toxin,/turf/simulated/floor/wood,/area/planet/forest/cabin1/attic)
"F" = (/obj/item/clothing/head/urist/historic/armor/valkyrie,/obj/item/clothing/suit/urist/armor/historic/chain/early_chainmail,/obj/item/weapon/material/sword,/obj/random/treasure,/obj/random/treasure,/obj/item/clothing/shoes/jackboots/medievalboots,/obj/item/clothing/under/urist/historic/leather_tunic,/obj/item/remains/human,/obj/structure/closet/coffin/urist/stonecoffin,/turf/simulated/floor/planet/jungle/clear/underground,/area/planet/forest/upper)
"H" = (/mob/living/simple_animal/opossum,/turf/simulated/floor,/area/planet/forest/cabin2/attic)
"J" = (/obj/structure/closet,/obj/random/accessory,/obj/random/clothing,/obj/random/clothing,/obj/random/handgun,/obj/random/ammo,/obj/random/ammo,/obj/item/clothing/suit/urist/sweater/pink,/turf/simulated/floor/wood,/area/planet/forest/cabin1/attic)
"K" = (/turf/simulated/open,/area/planet/forest/cabin1/attic)
"L" = (/obj/structure/closet,/obj/random/accessory,/obj/random/clothing,/obj/random/clothing,/obj/random/clothing,/obj/random/handgun,/obj/random/ammo,/obj/random/ammo,/obj/item/clothing/suit/urist/sweater/mint,/turf/simulated/floor/wood,/area/planet/forest/cabin1/attic)
"M" = (/obj/item/clothing/head/urist/historic/armor/medieval2,/turf/simulated/floor/planet/jungle/clear/underground,/area/planet/forest/upper)
"N" = (/mob/living/simple_animal/hostile/urist/skeleton/ancient,/turf/simulated/floor/planet/jungle/clear/underground,/area/planet/forest/upper)
"P" = (/turf/simulated/floor/planet/jungle/clear/underground,/area/planet/forest/upper)
"Q" = (/turf/simulated/floor/planet/jungle/rock/underground,/area/planet/forest/upper)
"R" = (/obj/structure/closet,/obj/item/weapon/gun/projectile/manualcycle/hunterrifle/scoped,/obj/item/weapon/gun/projectile/manualcycle/hunterrifle/scoped,/obj/item/weapon/material/knife/hunting,/obj/item/weapon/material/knife/hunting,/obj/item/ammo_magazine/a762mm/stripper,/obj/item/ammo_magazine/a762mm/stripper,/obj/item/ammo_magazine/a762mm/stripper,/obj/item/ammo_magazine/a762mm/stripper,/obj/item/ammo_magazine/a762mm/stripper,/obj/item/ammo_magazine/a762mm/stripper,/turf/simulated/floor/wood,/area/planet/forest/cabin1/attic)
"Y" = (/obj/random/trash,/turf/simulated/floor/wood,/area/planet/forest/cabin1/attic)
"Z" = (/obj/machinery/light_switch{pixel_x = -32; pixel_y = 24},/turf/simulated/floor/wood,/area/planet/forest/cabin1/attic)

(1,1,1) = {"
aaaaaaaaaaaaaaaaaaaaaaaaaaaaaaaaaaaaaaaaaaaaaaaaaaaaaaaaaaaaaaaaaaaaaaaaaaaaaaaaaaaaaaaaaaaaaaaaaaaa
aaaaaaaaaaaaaaaaaaaaaaaaaaaaaaaaaaaaaaaaaaaaaaaaaaaaaaaaaaaaaaaaaaaaaaaaaaaaaaaaaaaaaaaaaaaaaaaaaaaa
aaaaaaaaaaaaaaaaaaaaaaaaaaaaaaaaaaaaaaaaaaaaaaaaaaaaaaaaaaaaaaaaaaaaaaaaaaaaaaaaaaaaaaaaaaaaaaaaaaaa
aaaQQQQQQQQQQQQQQQQQQQQQQQQQQQQQQQbbbbbbbbbbbbbbbbbbbbbbbbbbbbbbbbbbbbbbbbbbbbbbbbbbbbbbbbbbbbbbbaaa
aaaQQQQQQQQQQQQQQQQQQQQQQQQQQQQQQQbbbbbbbbbbbbbbbbbbbbbbbbbbbbbbbbbbbbbbbbbbbbbbbbbbbbbbbbbbbbbbbaaa
aaaQQmmmPPPPPPPPNPPmmmmmPPPPPPPQbbbbbbbbbbbbbbbbbbbbbbbbbbbbbbbbbbbbbbbbbbbbbbbbbbbbbbbbbbbbbbbbbaaa
aaaQQmmmPPmyPmmmPPPbbmmmmmmQPPPQbbbbbbbbbbbbbbbbbbbbbbbbbbbbbbbbbbbbbbbbbbbbbbbbbbbbbbbbbbbbbbbbbaaa
aaaQQPPPmPPPmmmmPPPbbvvvvvvQPPPQvvvvvvvvvvvvvvvvvvvvvvvvvvvvvvvvvvvvvvvvvvvvvvvvvvvvvvvvvvvvvbbbbaaa
aaaQQPPpPPlPMPmmPPbbvvvvvvvQPNPQvvvvvvvvvvvvvvvvvvvvvvvvvvvvvvvvvvvvvvvvvvvvvvvvvvvvvvvvvvvvvbbbbaaa
aaaQQPmPPPPPPmmmmPbvvvvvvvvQmmmQvvvvvvvvvvvvvvvvvvvvvvvvvvvvvvvvvvvvvvvvvvvvvvvvvvvvvvvvvvvvvbbbbaaa
aaaQQPPymmPmPPPPNPbvvvvvvvvQmmmQvvvvvvvvvvvvvvvvvvvvvvvvvvvvvvvvvvvvvvvvvvvvvvvvvvvvvvvvvvvvvbbbbaaa
aaaQQPPPPmmPmmPmPPbvvvvvvvvQmmmQvvvvvvvvvvvvvvvvvvvvvvvvvvvvvvvvvvvvvvvvvvvvvvvvvvvvvvvvvvvvvbbbbaaa
aaaQQPPmPPPmPPypPbbvvvvvvvvQPmPQvvvvvvvvvvvvvvvvvvvvvvvvvvvvvvvvvvvvvvvvvvvvvvvvvvvvvvvvvvvvvbbbbaaa
aaaQQPzmPNPPPPbbbbvvvvvvvvvQPFPQvvvvvvvvvvvvvvvvvvvvvvvvvvvvvvvvvvvvvvvvvvvvvvvvvvvvvvvvvvvvvbbbbaaa
aaaQQPmmPPPPPPbvvvvvvvvvvvvQPPQQvvvvvvvvvvvvvvvvvvvvvvvvvvvvvvvvvvvvvvvvvvvvvvvvvvvvvvvvvvvvvbbbbaaa
aaaQQPmmPPmmmmbvvvvvvvvvvvvQQQQvvvvvvvvvvvvvvvvvvvvvvvvvvvvvvvvvvvvvvvvvvvvvvvvvvvvvvvvvvvvvvbbbbaaa
aaaQQPPPPmvvvvvvvvvvvvvvvvvvvvvvvvvvvvvvvvvvvvvvvvvvvvvvvvvvvvvvvvvvvvvvvvvvvvvvvvvvvvvvvvvvvbbbbaaa
aaaQQQQmmcvvvvvvvvvvvvvvvvvvvvvvvvvvvvvvvvvvvvvvvvvvvvvvvvvvvvvvvvvvvvvvvvvvvvvvvvvvvvvvvvvvvbbbbaaa
aaabbbbvvvvvvvvvvvvvvvvvvvvvvvvvvvvvvvvvvvvvvvvvvvvvvvvvvvvvvvvvvvvvvvvvvvvvvvvvvvvvvvvvvvvvvbbbbaaa
aaabbbbvvvvvvvvvvvvvvvvvvvvvvvvvvvvvvvvvvvvvvvvvvvvvvvvvvvvvvvvvvvvvvvvvvvvvvvvvvvvvvvvvvvvvvbbbbaaa
aaabbbbvvvvvvvvvvvvvvvvvvvvvvvvvvvvvvvvvvvvvvvvvvvvvvvvvvvvvvvvvvvvvvvvvvvvvvvvvvvvvvvvvvvvvvbbbbaaa
aaabbbbvvvvvvvvvvvvvvvvvvvvvvvvvvvvvvvvvvvvvvvvvvvvvvvvvvvvvvvvvvvvvvvvvvvvvvvvvvvvvvvvvvvvvvbbbbaaa
aaabbbbvvvvvvvvvvvvvvvvvvvvvvvvvvvvvvvvvvvvvvvvvvvvvvvvvvvvvvvvvvvvvvvvvvvvvvvvvvvvvvvvvvvvvvbbbbaaa
aaabbbbvvvvvvvvvvvvvvvvvvvvvvvvvvvvvvvvvvvvvvvvvvvvvvvvvvvvvvvvvvvvvvvvvvvvvvvvvvvvvvvvvvvvvvbbbbaaa
aaabbbbvvvvvvvvvvvvvvvvvvvvvvvvvvvvvvvvvvvvvvvvvvvvvvvvvvvvvvvvvvvvvvvvvvvvvvvvvvvvvvvvvvvvvvbbbbaaa
aaabbbbvvvvvvvvvvvvvvvvvvvvvvvvvvvvvvvvvvvvvvvvvvvvvvvvvvvvvvvvvvvvvvvvvvvvvvvvvvvvvvvvvvvvvvbbbbaaa
aaabbbbvvvvvvvvvvvvvvvvvvvvvvvvvvvvvvvvvvvvvvvvvvvvvvvvvvvvvvvvvvvvvvvvvvvvvvvvvvvvvvvvvvvvvvbbbbaaa
aaabbbbvvvvvvvvvvvvvvvvvvvvvvvvvvvvvvvvvvvvvvvvvvvvvvvvvvvvvvvvvvvvvvvvvvvvvvvvvvvvvvvvvvvvvvbbbbaaa
aaabbbbvvvvvvvvvvvvvvvvvvvvvvvvvvvvvvvvvvvvvvvvvvvvvvvvvvvvvvvvvvvvvvvvvvvvvvvvvvvvvvvvvvvvvvbbbbaaa
aaabbbbvvvvvvvvvvvvvvvvvvvvvvvvvvvvvvvvvvvvvvvvvvvvvvvvvvvvvvvvvvvvvvvvvvvvvvvvvvvvvvvvvvvvvvbbbbaaa
aaabbbbvvvvvvvvvvvvvvvvvvvvvvvvvvvvvvvvvvvvvvvvvvvvvvvvvvvvvvvvvvvvvvvvvvvvvvvvvvvvvvvvvvvvvvbbbbaaa
aaabbbbvvvvvvvvvvvvvvvvvvvvvvvvvvvvvvvvvvvvvvvvvvvvvvvvvvvvvvvvvvvvvvvvvvvvvvvvvvvvvvvvvvvvvvbbbbaaa
aaabbbbvvvvvvvvvvvvvvvvvvvvvvvvvvvvvvvvvvvvvvvvvvvvvvvvvvvvvvvvvvvvvvvvvvvvvvvvvvvvvvvvvvvvvvbbbbaaa
aaabbbbvvvvvvvvvvvvvvvvvvvvvvvvvvvvvvvvvvvvvvvvvvvvvvvvvvvvvvvvvvvvvvvvvvvvvvvvvvvvvvvvvvvvvvbbbbaaa
aaabbbbvvvvvvvvvvvvvvvvvvvvvvvvvvvvvvvvvvvvvvvvvvvvvvvvvvvvvvvvvvvvvvvvvvvvvvvvvvvvvvvvvvvvvvbbbbaaa
aaabbbbvvvvvvvvvvvvvvvvvvvvvvvvvvvvvvvvvvvvvvvvvvvvvvvvvvvvvvvvvvvvvvvvvvvvvvvvvvvvvvvvvvvvvvbbbbaaa
aaabbbbvvvvvvvvvvvvvvvvvvvvvvvvvvvvvvvvvvvvvvvvvvvvvvvvvvvvvvvvvvvvvvvvvvvvvvvvvvvvvvvvvvvvvvbbbbaaa
aaabbbbvvvvvvvvvvvvvvvvvvvvvvvvvvvvvvvvvvvvvvvvvvvvvvvvvvvvvvvvvvvvvvvvvvvvvvvvvvvvvvvvvvvvvvbbbbaaa
aaabbbbvvvvvvvvvvvvvvvvvvvvvvvvvvvvvvvvvvvvvvvvvvvvvvvvvvvvvvvvvvvvvvvvvvvvvvvvvvvvvvvvvvvvvvbbbbaaa
aaabbbbvvvvvvvvvvvvvvvvvvvvvvvvvvvvvvvvvvvvvvvvvvvvvvvvvvvvvvvvvvvvvvvvvvvvvvvvvvvvvvvvvvvvvvbbbbaaa
aaabbbbvvvvvvvvvvvvvvvvvvvvvvvvvvvvvvvvvvvvvvvvvvvvvvvvvvvvvvvvvvvvvvvvvvvvvvvvvvvvvvvvvvvvvvbbbbaaa
aaabbbbvvvvvvvvvvvvvvvvvvvvvvvvvvvvvvvvvvvvvvvvvvvvvvvvvvvvvvvvvvvvvvvvvvvvvvvvvvvvvvvvvvvvvvbbbbaaa
aaabbbbvvvvvvvvvvvvvvvvvvvvvvvvvvvvvvvvvvvvvvvvvvvvvvvvvvvvvvvvvvvvvvvvvvvvvvvvvvvvvvvvvvvvvvbbbbaaa
aaabbbbvvvvvvvvvvvvvvvvvvvvvvvvvvvvvvvvvvvvvvvvvvvvvvvvvvvvvvvvvvvvvvvvvvvvvvvvvvvvvvvvvvvvvvbbbbaaa
aaabbbbvvvvvvvvvvvvvvvvvvvvvvvvvvvvvvvvvvvvvvvvvvvvvvvvvvvvvvvvvvvvvvvvvvvvvvvvvvvvvvvvvvvvvvbbbbaaa
aaabbbbvvvvvvvvvvvvvvvvvvvvvvvvvvvvvvvvvvvvvvvvvvvvvvvvvvvvvvvvvvvvvvvvvvvvvvvvvvvvvvvvvvvvvvbbbbaaa
aaabbbbvvvvvvvvvvvvvvvvvvvvvvvvvvvvvvvvvvvvvvvvvvvvvvvvvvvvvvvvvvvvvvvvvvvvvvvvvvvvvvvvvvvvvvbbbbaaa
aaabbbbvvvvvvvvvvvvvvvvvvvvvvvvvvvvvvvvvvvvvvvvvvvvvvvvvvvvvvvvvvvvvvvvvvvvvvvvvvvvvvvvvvvvvvbbbbaaa
aaabbbbvvvvvvvvvvvvvvvvvvvvvvvvvvvvvvvvvvvvvvvvvvvvvvvvvvvvvvvvvvvvvvvvvvvvvvvvvvvvvvvvvvvvvvbbbbaaa
aaabbbbvvvvvvvvvvvvvvvvvvvvvvvvvvvvvvvvvvvvvvvvvvvvvvvvvvvvvvvvvvvvvvvvvvvvvvvvvvvvvvvvvvvvvvbbbbaaa
aaabbbbvvvvvvvvvvvvvvvvvvvvvvvvvvvvvvvvvvvvvvvvvvvvvvvvvvvvvvvvvvvvvvvvvvvvvvvvvvvvvvvvvvvvvvbbbbaaa
aaabbbbvvvvvvvvvvvvvvvvvvvvvvvvvvvvvvvvvvvvvvvvvvvvvvvvvvvvvvvvvvvvvvvvvvvvvvvvvvvvvvvvvvvvvvbbbbaaa
aaabbbbvvvvvvvvvvvvvvvvvvvvvvvvvvvvvvvvvvvvvvvvvvvvvvvvvvvvvvvvvvvvvvvvvvvvvvvvvvvvvvvvvvvvvvbbbbaaa
aaabbbbvvvvvvvvvvvvvvvvvvvvvvvvvvvvvvvvvvvvvvvvvvvvvvvvvvvvvvvvvvvvvvvvvvvvvvvvvvvvvvvvvvvvvvbbbbaaa
aaabbbbvvvvvvvvvvvvvvvvvvvvvvvvvvvvvvvvvvvvvvvvvvvvvvvvvvvvvvvvvvvvvvttttttttttttttttttvvvvvvbbbbaaa
aaabbbbvvvvvvvvvvvvvvvvvvvvvvvvvvvvvvvvvvvvvvvvvvvvvvvvvvvvvvvvvvvvvvttttttttttttttttttvvvvvvbbbbaaa
aaabbbbvvvvvvvvvvvvvvvvvvvvvvvvvvvvvvvvvvvvvvvvvvvvvvvvvvvvvvvvvvvvvvttttttttttttttttttvvvvvvbbbbaaa
aaabbbbvvvvvvvvvvvvvvvvvvvvvvvvvvvvvvvvvvvvvvvvvvvvvvvvvvvvvvvvvvvvvvttttttttttttttttttvvvvvvbbbbaaa
aaabbbbvvvvvvvvvvvvvvvvvvvvvvvvvvvvvvvvvvvvvvvvvvvvvvvvvvvvvvvvvvvvvvtttttttdddttttttttvvvvvvbbbbaaa
aaabbbbvvvvvvvvvvvvvvvvvvvvvvvvvvvvvvvvvvvvvvvvvvvvvvvvvvvvvvvvvvvvvvtttttttHddttttttttvvvvvvbbbbaaa
aaabbbbvvvvvvvvvvvvvvvvvvvvvvvvvvvvvvvvvvvvvvvvvvvvvvvvvvvvvvvvvvvvvvttttttttttttttttttvvvvvvbbbbaaa
aaabbbbvvvvvvvvvvvvvvvvvvvvvvvvvvvvvvvvvvvvvvvvvvvvvvvvvvvvvvvvvvvvvvttttttttttttttttttvvvvvvbbbbaaa
aaabbbbvvvvvvvvvvvvvvvvvvvvvvvvvvvvvvvvvvvvvvvvvvvvvvvvvvvvvvvvvvvvvvttttttttttttttttttvvvvvvbbbbaaa
aaabbbbvvvvvvvvvvvvvvvvvvvvvvvvvvvvvvvvvvvvvvvvvvvvvvvvvvvvvvvvvvvvvvttttttttttttttttttvvvvvvbbbbaaa
aaabbbbvvvvvvvvvvvvvvvvvvvvvvvvvvvvvvvvvvvvvvvvvvvvvvvvvvvvvvvvvvvvvvttttttttttttttttttvvvvvvbbbbaaa
aaabbbbvvvvvvvvvvvvvvvvvvvvvvvvvvvvvvvvvvvvvvvvvvvvvvvvvvvvvvvvvvvvvvttttttttttttttttttvvvvvvbbbbaaa
aaabbbbvvvvvvvvvvvvvvvvvvvvvvvvvvvvvvvvvvvvvvvvvvvvvvvvvvvvvvvvvvvvvvttttttttttttttttttvvvvvvbbbbaaa
aaabbbbvvvvvvvvvvvvvvvvvvvvvvvvvvvvvvvvvvvvvvvvvvvvvvvvvvvvvvvvvvvvvvttttttttttttttttttvvvvvvbbbbaaa
aaabbbbvvvvvvvvvvvvvvvvvvvvvvvvvvvvvvvvvvvvvvvvvvvvvvvvvvvvvvvvvvvvvvttttttttttttttttttvvvvvvbbbbaaa
aaabbbbvvvvvvvvvvvvvvvvvvvvvvvvvvvvvvvvvvvvvvvvvvvvvvvvvvvvvvvvvvvvvvttttttttttttttttttvvvvvvbbbbaaa
aaabbbbvvvvvvvvvvvvvvvvvvvvvvvvvvvvvvvvvvvvvvvvvvvvvvvvvvvvvvvvvvvvvvvvvvvvvvvvvvvvvvvvvvvvvvbbbbaaa
aaabbbbvvvvvvvvvvvvvvvvvvvvvvvvvvvvvvvvvvvvvvvvvvvvvvvvvvvvvvvvvvvvvvvvvvvvvvvvvvvvvvvvvvvvvvbbbbaaa
aaabbbbvvvvvvvvvvvvvvvvvvvvvvvvvvvvvvvvvvvvvvvvvvvvvvvvvvvvvvvvvvvvvvvvvvvvvvvvvvvvvvvvvvvvvvbbbbaaa
aaabbbbvvvvvvvvvvvvvvvvvvvvvvvvvvvvvvvvvvvvvvvvvvvvvvvvvvvvvvvvvvvvvvvvvvvvvvvvvvvvvvvvvvvvvvbbbbaaa
aaabbbbvvvvvvvvvvvvvvvvvvvvvvvvvvvvvvvvvvvvvvvvvvvvvvvvvvvvvvvvvvvvvvvvvvvvvvvvvvvvvvvvvvvvvvbbbbaaa
aaabbbbvvvvvvvvvvvvvvvvvvvvvvvvvvvvvvvvvvvvvvvvvvvvvvvvvvvvvvvvvvvvvvvvvvvvvvvvvvvvvvvvvvvvvvbbbbaaa
aaabbbbvvvvvvvvvvvvvvvvvvvvvvvvvvvvvvvvvvvvvvvvvvvvvvvvvvvvvvvvvvvvvvvvvvoooooooooooooooooooobbbbaaa
aaabbbbvvvvvvvvvvvvvvvvvvvvvvvvvvvvvvvvvvvvvvvvvvvvvvvvvvvvvvvvvvvvvvvvvvoooooooooooooooooooobbbbaaa
aaabbbbvvvvvvvvvvvvvvvvvvvvvvvvvvvvvvvvvvvvvvvvvvvvvvvvvvvvvvvvvvvvvvvvvvoooooooooooooooooooobbbbaaa
aaabbbbvvvvvvvvvvvvvvvvvvvvvvvvvvvvvvvvvvvvvvvvvvvvvvvvvvvvvvvvvvvvvvvvvvoooeeffeeeffeeoooooobbbbaaa
aaabbbbvvvvvvvvvvvvvvvvvvvvvvvvvvvvvvvvvvvvvvvvvvvvvvvvvvvvvvvvvvvvvvvvvvooofguwqJEZgLeoooooobbbbaaa
aaabbbbvvvvvvvvvvvvvvvvvvvvvvvvvvvvvvvvvvvvvvvvvvvvvvvvvvvvvvvvvvvvvvvvvvooofgggggggggeoooooobbbbaaa
aaabbbbvvvvvvvvvvvvvvvvvvvvvvvvvvvvvvvvvvvvvvvvvvvvvvvvvvvvvvvvvvvvvvvvvvooofggggYigYgeoooooobbbbaaa
aaabbbbvvvvvvvvvvvvvvvvvvvvvvvvvvvvvvvvvvvvvvvvvvvvvvvvvvvvvvvvvvvvvvvvvvooofgiYggghgReoooooobbbbaaa
aaabbbbvvvvvvvvvvvvvvvvvvvvvvvvvvvvvvvvvvvvvvvvvvvvvvvvvvvvvvvvvvvvvvvvvvooofgggigggggeoooooobbbbaaa
aaabbbbvvvvvvvvvvvvvvvvvvvvvvvvvvvvvvvvvvvvvvvvvvvvvvvvvvvvvvvvvvvvvvvvvvooofjgngAigggeoooooobbbbaaa
aaabbbbvvvvvvvvvvvvvvvvvvvvvvvvvvvvvvvvvvvvvvvvvvvvvvvvvvvvvvvvvvvvvvvvvvooofgggghgYggeoooooobbbbaaa
aaabbbbvvvvvvvvvvvvvvvvvvvvvvvvvvvvvvvvvvvvvvvvvvvvvvvvvvvvvvvvvvvvvvvvvvooofggAgAggKKeoooooobbbbaaa
aaabbbbvvvvvvvvvvvvvvvvvvvvvvvvvvvvvvvvvvvvvvvvvvvvvvvvvvvvvvvvvvvvvvvvvvoooeeeeeeeeeeeoooooobbbbaaa
aaabbbbvvvvvvvvvvvvvvvvvvvvvvvvvvvvvvvvvvvvvvvvvvvvvvvvvvvvvvvvvvvvvvvvvvoooKKKKKKeKKKKoooooobbbbaaa
aaabbbbvvvvvvvvvvvvvvvvvvvvvvvvvvvvvvvvvvvvvvvvvvvvvvvvvvvvvvvvvvvvvvvvvvoooKKKKKKKKKKKoooooobbbbaaa
aaabbbbvvvvvvvvvvvvvvvvvvvvvvvvvvvvvvvvvvvvvvvvvvvvvvvvvvvvvvvvvvvvvvvvvvoooKKKKKKKKKKKoooooobbbbaaa
aaabbbbvvvvvvvvvvvvvvvvvvvvvvvvvvvvvvvvvvvvvvvvvvvvvvvvvvvvvvvvvvvvvvvvvvoooKKKKKKKKKKKoooooobbbbaaa
aaabbbbbbbbbbbbbbbbbbbbbbbbbbbbbbbbbbbbbbbbbbbbbbbbbbbbbbbbbbbbbbbbbbbbbbbbbbbbbbbbbbbbbbbbbbbbbbaaa
aaabbbbbbbbbbbbbbbbbbbbbbbbbbbbbbbbbbbbbbbbbbbbbbbbbbbbbbbbbbbbbbbbbbbbbbbbbbbbbbbbbbbbbbbbbbbbbbaaa
aaabbbbbbbbbbbbbbbbbbbbbbbbbbbbbbbbbbbbbbbbbbbbbbbbbbbbbbbbbbbbbbbbbbbbbbbbbbbbbbbbbbbbbbbbbbbbbbaaa
aaabbbbbbbbbbbbbbbbbbbbbbbbbbbbbbbbbbbbbbbbbbbbbbbbbbbbbbbbbbbbbbbbbbbbbbbbbbbbbbbbbbbbbbbbbbbbbbaaa
aaaaaaaaaaaaaaaaaaaaaaaaaaaaaaaaaaaaaaaaaaaaaaaaaaaaaaaaaaaaaaaaaaaaaaaaaaaaaaaaaaaaaaaaaaaaaaaaaaaa
aaaaaaaaaaaaaaaaaaaaaaaaaaaaaaaaaaaaaaaaaaaaaaaaaaaaaaaaaaaaaaaaaaaaaaaaaaaaaaaaaaaaaaaaaaaaaaaaaaaa
kaaaaaaaaaaaaaaaaaaaaaaaaaaaaaaaaaaaaaaaaaaaaaaaaaaaaaaaaaaaaaaaaaaaaaaaaaaaaaaaaaaaaaaaaaaaaaaaaaaa
"}
