//MAP CONVERTED BY dmm2tgm.py THIS HEADER COMMENT PREVENTS RECONVERSION, DO NOT REMOVE
"a" = (
/turf/unsimulated/wall/urist/other/border,
/area/space)
"b" = (
/turf/simulated/floor/planet/jungle/rock,
/area/planet/forest/upper)
"c" = (
/turf/simulated/open/skylight/planet,
/area/planet/forest/upper)
"d" = (
/obj/structure/closet,
/obj/item/gun/projectile/manualcycle/hunterrifle/scoped,
/obj/item/gun/projectile/manualcycle/hunterrifle/scoped,
/obj/item/material/knife/hunting,
/obj/item/material/knife/hunting,
/turf/simulated/floor/wood,
/area/planet/forest/cabin1/attic)
"e" = (
/turf/simulated/wall/wood,
/area/planet/forest/cabin1/attic)
"f" = (
/obj/effect/wingrille_spawn/reinforced/full,
/turf/simulated/floor/wood,
/area/planet/forest/cabin1/attic)
"g" = (
/turf/simulated/floor/wood,
/area/planet/forest/cabin1/attic)
"h" = (
/turf/simulated/floor/wood{
	icon_state = "wood_broken5"
	},
/area/planet/forest/cabin1/attic)
"i" = (
/turf/simulated/floor/wood{
	icon_state = "wood_broken1"
	},
/area/planet/forest/cabin1/attic)
"j" = (
/turf/simulated/floor/wood{
	icon_state = "wood_broken6"
	},
/area/planet/forest/cabin1/attic)
"k" = (
/obj/effect/landmark/map_data{
	height = 3
	},
/turf/space,
/area/space)
"l" = (
/obj/structure/ladder,
/turf/simulated/floor/planet/jungle/clear/underground,
/area/planet/forest/upper)
"m" = (
/turf/simulated/mineral/random{
	mined_turf = /turf/simulated/floor/planet/jungle/clear/underground
	},
/area/planet/forest/upper)
"n" = (
/obj/structure/bed,
/obj/effect/submap_landmark/joinable_submap/caraway_forest,
/turf/simulated/floor/wood,
/area/planet/forest/cabin1/attic)
"o" = (
/turf/simulated/open/skylight/planet,
/area/planet/forest/cabin1/attic)
"p" = (
/obj/item/remains/human,
/turf/simulated/floor/planet/jungle/clear/underground,
/area/planet/forest/upper)
"q" = (
/obj/structure/closet,
/obj/random/accessory,
/obj/random/clothing,
/obj/random/clothing,
/obj/item/clothing/suit/urist/sweater/blue/heart,
/obj/item/gun/projectile/pistol/optimus,
/obj/item/gun/projectile/pistol/optimus,
/obj/item/ammo_magazine/pistol/double,
/obj/item/ammo_magazine/pistol/double,
/obj/item/ammo_magazine/pistol/double,
/obj/item/ammo_magazine/pistol/double,
/obj/item/ammo_magazine/pistol/double,
/obj/item/ammo_magazine/pistol/double,
/turf/simulated/floor/wood,
/area/planet/forest/cabin1/attic)
"r" = (
/mob/living/simple_animal/passive/opossum,
/turf/simulated/floor/wood,
/area/planet/forest/cabin1/attic)
"t" = (
/turf/simulated/open/skylight,
/area/planet/forest/cabin2/attic)
"u" = (
/obj/structure/roller_bed,
/turf/simulated/floor/wood{
	icon_state = "wood_broken5"
	},
/area/planet/forest/cabin1/attic)
"v" = (
/turf/simulated/open/skylight,
/area/planet/forest/upper)
"w" = (
/obj/structure/table/rack/wood,
/obj/item/reagent_containers/spray/sterilizine,
/obj/item/flame/lighter/cyan,
/obj/item/reagent_containers/glass/beaker/painkiller,
/obj/item/reagent_containers/glass/beaker/painkiller,
/obj/item/reagent_containers/pill/peridaxon,
/obj/item/reagent_containers/pill/peridaxon,
/obj/item/reagent_containers/pill/peridaxon,
/obj/item/storage/firstaid/surgery,
/turf/simulated/floor/wood,
/area/planet/forest/cabin1/attic)
"y" = (
/obj/effect/spider/stickyweb,
/turf/simulated/floor/planet/jungle/clear/underground,
/area/planet/forest/upper)
"z" = (
/turf/simulated/mineral/random,
/area/planet/forest/upper)
"A" = (
/obj/structure/bed,
/obj/effect/submap_landmark/spawnpoint/forest_settler,
/turf/simulated/floor/wood,
/area/planet/forest/cabin1/attic)
"C" = (
/turf/simulated/open/skylight/planet,
/area/planet/forest/cabin2/attic)
"E" = (
/obj/structure/table/rack/wood,
/obj/item/storage/firstaid/adv,
/obj/item/storage/firstaid,
/obj/item/storage/firstaid/toxin,
/turf/simulated/floor/wood,
/area/planet/forest/cabin1/attic)
"F" = (
/obj/item/clothing/head/urist/historic/armor/valkyrie,
/obj/item/clothing/suit/urist/armor/historic/chain/early_chainmail,
/obj/item/material/sword,
/obj/random/treasure,
/obj/random/treasure,
/obj/item/clothing/shoes/jackboots/medievalboots,
/obj/item/clothing/under/urist/historic/leather_tunic,
/obj/structure/closet/coffin/urist/stonecoffin,
/mob/living/simple_animal/hostile/urist/skeleton/ancient/ranged,
/turf/simulated/floor/planet/jungle/clear/underground,
/area/planet/forest/upper)
"H" = (
/turf/simulated/floor,
/area/planet/forest/cabin2/attic)
"J" = (
/obj/structure/closet,
/obj/random/accessory,
/obj/random/clothing,
/obj/random/clothing,
/obj/item/clothing/suit/urist/sweater/pink,
/obj/item/gun/projectile/pistol/optimus,
/obj/item/ammo_magazine/pistol/double,
/obj/item/ammo_magazine/pistol/double,
/obj/item/ammo_magazine/pistol/double,
/turf/simulated/floor/wood,
/area/planet/forest/cabin1/attic)
"K" = (
/turf/simulated/open,
/area/planet/forest/cabin1/attic)
"L" = (
/obj/structure/closet,
/obj/random/accessory,
/obj/random/clothing,
/obj/random/clothing,
/obj/random/clothing,
/obj/item/clothing/suit/urist/sweater/mint,
/obj/item/gun/projectile/pistol/optimus,
/obj/item/ammo_magazine/pistol/double,
/obj/item/ammo_magazine/pistol/double,
/turf/simulated/floor/wood,
/area/planet/forest/cabin1/attic)
"M" = (
/obj/item/clothing/head/urist/historic/armor/medieval2,
/turf/simulated/floor/planet/jungle/clear/underground,
/area/planet/forest/upper)
"N" = (
/mob/living/simple_animal/hostile/urist/skeleton/ancient,
/turf/simulated/floor/planet/jungle/clear/underground,
/area/planet/forest/upper)
"O" = (
/turf/unsimulated/mask,
/area/planet/forest/cabin1/attic)
"P" = (
/turf/simulated/floor/planet/jungle/clear/underground,
/area/planet/forest/upper)
"Q" = (
/turf/simulated/floor/planet/jungle/rock/underground,
/area/planet/forest/upper)
"Y" = (
/obj/random/trash,
/turf/simulated/floor/wood,
/area/planet/forest/cabin1/attic)
"Z" = (
/obj/machinery/light_switch{
	pixel_x = -32;
	pixel_y = 24
	},
/turf/simulated/floor/wood,
/area/planet/forest/cabin1/attic)

(1,1,1) = {"
a
a
a
a
a
a
a
a
a
a
a
a
a
a
a
a
a
a
a
a
a
a
a
a
a
a
a
a
a
a
a
a
a
a
a
a
a
a
a
a
a
a
a
a
a
a
a
a
a
a
a
a
a
a
a
a
a
a
a
a
a
a
a
a
a
a
a
a
a
a
a
a
a
a
a
a
a
a
a
a
a
a
a
a
a
a
a
a
a
a
a
a
a
a
a
a
a
a
a
k
"}
(2,1,1) = {"
a
a
a
a
a
a
a
a
a
a
a
a
a
a
a
a
a
a
a
a
a
a
a
a
a
a
a
a
a
a
a
a
a
a
a
a
a
a
a
a
a
a
a
a
a
a
a
a
a
a
a
a
a
a
a
a
a
a
a
a
a
a
a
a
a
a
a
a
a
a
a
a
a
a
a
a
a
a
a
a
a
a
a
a
a
a
a
a
a
a
a
a
a
a
a
a
a
a
a
a
"}
(3,1,1) = {"
a
a
a
a
a
a
a
a
a
a
a
a
a
a
a
a
a
a
a
a
a
a
a
a
a
a
a
a
a
a
a
a
a
a
a
a
a
a
a
a
a
a
a
a
a
a
a
a
a
a
a
a
a
a
a
a
a
a
a
a
a
a
a
a
a
a
a
a
a
a
a
a
a
a
a
a
a
a
a
a
a
a
a
a
a
a
a
a
a
a
a
a
a
a
a
a
a
a
a
a
"}
(4,1,1) = {"
a
a
a
Q
Q
Q
Q
Q
Q
Q
Q
Q
Q
Q
Q
Q
Q
Q
b
b
b
b
b
b
b
b
b
b
b
b
b
b
b
b
b
b
b
b
b
b
b
b
b
b
b
b
b
b
b
b
b
b
b
b
b
b
b
b
b
b
b
b
b
b
b
b
b
b
b
b
b
b
b
b
b
b
b
b
b
b
b
b
b
b
b
b
b
b
b
b
b
b
b
b
b
b
b
a
a
a
"}
(5,1,1) = {"
a
a
a
Q
Q
Q
Q
Q
Q
Q
Q
Q
Q
Q
Q
Q
Q
Q
b
b
b
b
b
b
b
b
b
b
b
b
b
b
b
b
b
b
b
b
b
b
b
b
b
b
b
b
b
b
b
b
b
b
b
b
b
b
b
b
b
b
b
b
b
b
b
b
b
b
b
b
b
b
b
b
b
b
b
b
b
b
b
b
b
b
b
b
b
b
b
b
b
b
b
b
b
b
b
a
a
a
"}
(6,1,1) = {"
a
a
a
Q
Q
m
m
P
P
P
P
P
P
P
P
P
P
Q
b
b
b
b
b
b
b
b
b
b
b
b
b
b
b
b
b
b
b
b
b
b
b
b
b
b
b
b
b
b
b
b
b
b
b
b
b
b
b
b
b
b
b
b
b
b
b
b
b
b
b
b
b
b
b
b
b
b
b
b
b
b
b
b
b
b
b
b
b
b
b
b
b
b
b
b
b
b
b
a
a
a
"}
(7,1,1) = {"
a
a
a
Q
Q
m
m
P
P
m
P
P
P
z
m
m
P
Q
b
b
b
b
b
b
b
b
b
b
b
b
b
b
b
b
b
b
b
b
b
b
b
b
b
b
b
b
b
b
b
b
b
b
b
b
b
b
b
b
b
b
b
b
b
b
b
b
b
b
b
b
b
b
b
b
b
b
b
b
b
b
b
b
b
b
b
b
b
b
b
b
b
b
b
b
b
b
b
a
a
a
"}
(8,1,1) = {"
a
a
a
Q
Q
m
m
P
p
P
y
P
m
m
m
m
P
m
c
c
c
c
c
c
c
c
c
c
c
c
c
c
c
c
c
c
c
c
c
c
c
c
c
c
c
c
c
c
c
c
c
c
c
c
c
c
c
c
c
c
c
c
c
c
c
c
c
c
c
c
c
c
c
c
c
c
c
c
c
c
c
c
c
c
c
c
c
c
c
c
c
c
c
b
b
b
b
a
a
a
"}
(9,1,1) = {"
a
a
a
Q
Q
P
P
m
P
P
m
P
P
P
P
P
P
m
c
c
c
c
c
c
c
c
c
c
c
c
c
c
c
c
c
c
c
c
c
c
c
c
c
c
c
c
c
c
c
c
c
c
c
c
c
c
c
c
c
c
c
c
c
c
c
c
c
c
c
c
c
c
c
c
c
c
c
c
c
c
c
c
c
c
c
c
c
c
c
c
c
c
c
b
b
b
b
a
a
a
"}
(10,1,1) = {"
a
a
a
Q
Q
P
P
P
P
P
m
m
P
N
P
P
m
c
c
c
c
c
c
c
c
c
c
c
c
c
c
c
c
c
c
c
c
c
c
c
c
c
c
c
c
c
c
c
c
c
c
c
c
c
c
c
c
c
c
c
c
c
c
c
c
c
c
c
c
c
c
c
c
c
c
c
c
c
c
c
c
c
c
c
c
c
c
c
c
c
c
c
c
b
b
b
b
a
a
a
"}
(11,1,1) = {"
a
a
a
Q
Q
P
m
P
l
P
P
m
P
P
P
m
c
c
c
c
c
c
c
c
c
c
c
c
c
c
c
c
c
c
c
c
c
c
c
c
c
c
c
c
c
c
c
c
c
c
c
c
c
c
c
c
c
c
c
c
c
c
c
c
c
c
c
c
c
c
c
c
c
c
c
c
c
c
c
c
c
c
c
c
c
c
c
c
c
c
c
c
c
b
b
b
b
a
a
a
"}
(12,1,1) = {"
a
a
a
Q
Q
P
y
P
P
P
m
P
m
P
P
m
c
c
c
c
c
c
c
c
c
c
c
c
c
c
c
c
c
c
c
c
c
c
c
c
c
c
c
c
c
c
c
c
c
c
c
c
c
c
c
c
c
c
c
c
c
c
c
c
c
c
c
c
c
c
c
c
c
c
c
c
c
c
c
c
c
c
c
c
c
c
c
c
c
c
c
c
c
b
b
b
b
a
a
a
"}
(13,1,1) = {"
a
a
a
Q
Q
P
P
m
M
P
P
m
P
P
P
m
c
c
c
c
c
c
c
c
c
c
c
c
c
c
c
c
c
c
c
c
c
c
c
c
c
c
c
c
c
c
c
c
c
c
c
c
c
c
c
c
c
c
c
c
c
c
c
c
c
c
c
c
c
c
c
c
c
c
c
c
c
c
c
c
c
c
c
c
c
c
c
c
c
c
c
c
c
b
b
b
b
a
a
a
"}
(14,1,1) = {"
a
a
a
Q
Q
P
m
m
P
m
P
m
P
P
P
m
c
c
c
c
c
c
c
c
c
c
c
c
c
c
c
c
c
c
c
c
c
c
c
c
c
c
c
c
c
c
c
c
c
c
c
c
c
c
c
c
c
c
c
c
c
c
c
c
c
c
c
c
c
c
c
c
c
c
c
c
c
c
c
c
c
c
c
c
c
c
c
c
c
c
c
c
c
b
b
b
b
a
a
a
"}
(15,1,1) = {"
a
a
a
Q
Q
P
m
m
m
m
P
P
y
b
b
b
c
c
c
c
c
c
c
c
c
c
c
c
c
c
c
c
c
c
c
c
c
c
c
c
c
c
c
c
c
c
c
c
c
c
c
c
c
c
c
c
c
c
c
c
c
c
c
c
c
c
c
c
c
c
c
c
c
c
c
c
c
c
c
c
c
c
c
c
c
c
c
c
c
c
c
c
c
b
b
b
b
a
a
a
"}
(16,1,1) = {"
a
a
a
Q
Q
P
m
m
m
m
P
m
p
b
c
c
c
c
c
c
c
c
c
c
c
c
c
c
c
c
c
c
c
c
c
c
c
c
c
c
c
c
c
c
c
c
c
c
c
c
c
c
c
c
c
c
c
c
c
c
c
c
c
c
c
c
c
c
c
c
c
c
c
c
c
c
c
c
c
c
c
c
c
c
c
c
c
c
c
c
c
c
c
b
b
b
b
a
a
a
"}
(17,1,1) = {"
a
a
a
Q
Q
N
P
P
P
m
N
P
P
b
c
c
c
c
c
c
c
c
c
c
c
c
c
c
c
c
c
c
c
c
c
c
c
c
c
c
c
c
c
c
c
c
c
c
c
c
c
c
c
c
c
c
c
c
c
c
c
c
c
c
c
c
c
c
c
c
c
c
c
c
c
c
c
c
c
c
c
c
c
c
c
c
c
c
c
c
c
c
c
b
b
b
b
a
a
a
"}
(18,1,1) = {"
a
a
a
Q
Q
P
P
P
P
P
P
P
b
b
c
c
c
c
c
c
c
c
c
c
c
c
c
c
c
c
c
c
c
c
c
c
c
c
c
c
c
c
c
c
c
c
c
c
c
c
c
c
c
c
c
c
c
c
c
c
c
c
c
c
c
c
c
c
c
c
c
c
c
c
c
c
c
c
c
c
c
c
c
c
c
c
c
c
c
c
c
c
c
b
b
b
b
a
a
a
"}
(19,1,1) = {"
a
a
a
Q
Q
P
P
P
b
b
b
b
b
c
c
c
c
c
c
c
c
c
c
c
c
c
c
c
c
c
c
c
c
c
c
c
c
c
c
c
c
c
c
c
c
c
c
c
c
c
c
c
c
c
c
c
c
c
c
c
c
c
c
c
c
c
c
c
c
c
c
c
c
c
c
c
c
c
c
c
c
c
c
c
c
c
c
c
c
c
c
c
c
b
b
b
b
a
a
a
"}
(20,1,1) = {"
a
a
a
Q
Q
m
b
b
b
c
c
c
c
c
c
c
c
c
c
c
c
c
c
c
c
c
c
c
c
c
c
c
c
c
c
c
c
c
c
c
c
c
c
c
c
c
c
c
c
c
c
c
c
c
c
c
c
c
c
c
c
c
c
c
c
c
c
c
c
c
c
c
c
c
c
c
c
c
c
c
c
c
c
c
c
c
c
c
c
c
c
c
c
b
b
b
b
a
a
a
"}
(21,1,1) = {"
a
a
a
Q
Q
m
b
b
c
c
c
c
c
c
c
c
c
c
c
c
c
c
c
c
c
c
c
c
c
c
c
c
c
c
c
c
c
c
c
c
c
c
c
c
c
c
c
c
c
c
c
c
c
c
c
c
c
c
c
c
c
c
c
c
c
c
c
c
c
c
c
c
c
c
c
c
c
c
c
c
c
c
c
c
c
c
c
c
c
c
c
c
c
b
b
b
b
a
a
a
"}
(22,1,1) = {"
a
a
a
Q
Q
m
m
c
c
c
c
c
c
c
c
c
c
c
c
c
c
c
c
c
c
c
c
c
c
c
c
c
c
c
c
c
c
c
c
c
c
c
c
c
c
c
c
c
c
c
c
c
c
c
c
c
c
c
c
c
c
c
c
c
c
c
c
c
c
c
c
c
c
c
c
c
c
c
c
c
c
c
c
c
c
c
c
c
c
c
c
c
c
b
b
b
b
a
a
a
"}
(23,1,1) = {"
a
a
a
Q
Q
m
m
c
c
c
c
c
c
c
c
c
c
c
c
c
c
c
c
c
c
c
c
c
c
c
c
c
c
c
c
c
c
c
c
c
c
c
c
c
c
c
c
c
c
c
c
c
c
c
c
c
c
c
c
c
c
c
c
c
c
c
c
c
c
c
c
c
c
c
c
c
c
c
c
c
c
c
c
c
c
c
c
c
c
c
c
c
c
b
b
b
b
a
a
a
"}
(24,1,1) = {"
a
a
a
Q
Q
m
m
c
c
c
c
c
c
c
c
c
c
c
c
c
c
c
c
c
c
c
c
c
c
c
c
c
c
c
c
c
c
c
c
c
c
c
c
c
c
c
c
c
c
c
c
c
c
c
c
c
c
c
c
c
c
c
c
c
c
c
c
c
c
c
c
c
c
c
c
c
c
c
c
c
c
c
c
c
c
c
c
c
c
c
c
c
c
b
b
b
b
a
a
a
"}
(25,1,1) = {"
a
a
a
Q
Q
m
m
c
c
c
c
c
c
c
c
c
c
c
c
c
c
c
c
c
c
c
c
c
c
c
c
c
c
c
c
c
c
c
c
c
c
c
c
c
c
c
c
c
c
c
c
c
c
c
c
c
c
c
c
c
c
c
c
c
c
c
c
c
c
c
c
c
c
c
c
c
c
c
c
c
c
c
c
c
c
c
c
c
c
c
c
c
c
b
b
b
b
a
a
a
"}
(26,1,1) = {"
a
a
a
Q
Q
m
m
c
c
c
c
c
c
c
c
c
c
c
c
c
c
c
c
c
c
c
c
c
c
c
c
c
c
c
c
c
c
c
c
c
c
c
c
c
c
c
c
c
c
c
c
c
c
c
c
c
c
c
c
c
c
c
c
c
c
c
c
c
c
c
c
c
c
c
c
c
c
c
c
c
c
c
c
c
c
c
c
c
c
c
c
c
c
b
b
b
b
a
a
a
"}
(27,1,1) = {"
a
a
a
Q
Q
m
m
c
c
c
c
c
c
c
c
c
c
c
c
c
c
c
c
c
c
c
c
c
c
c
c
c
c
c
c
c
c
c
c
c
c
c
c
c
c
c
c
c
c
c
c
c
c
c
c
c
c
c
c
c
c
c
c
c
c
c
c
c
c
c
c
c
c
c
c
c
c
c
c
c
c
c
c
c
c
c
c
c
c
c
c
c
c
b
b
b
b
a
a
a
"}
(28,1,1) = {"
a
a
a
Q
Q
m
Q
Q
Q
Q
Q
Q
Q
Q
Q
Q
c
c
c
c
c
c
c
c
c
c
c
c
c
c
c
c
c
c
c
c
c
c
c
c
c
c
c
c
c
c
c
c
c
c
c
c
c
c
c
c
c
c
c
c
c
c
c
c
c
c
c
c
c
c
c
c
c
c
c
c
c
c
c
c
c
c
c
c
c
c
c
c
c
c
c
c
c
b
b
b
b
a
a
a
"}
(29,1,1) = {"
a
a
a
Q
Q
P
P
P
P
m
m
m
P
P
P
Q
c
c
c
c
c
c
c
c
c
c
c
c
c
c
c
c
c
c
c
c
c
c
c
c
c
c
c
c
c
c
c
c
c
c
c
c
c
c
c
c
c
c
c
c
c
c
c
c
c
c
c
c
c
c
c
c
c
c
c
c
c
c
c
c
c
c
c
c
c
c
c
c
c
c
c
c
c
b
b
b
b
a
a
a
"}
(30,1,1) = {"
a
a
a
Q
Q
P
P
P
N
m
m
m
m
F
P
Q
c
c
c
c
c
c
c
c
c
c
c
c
c
c
c
c
c
c
c
c
c
c
c
c
c
c
c
c
c
c
c
c
c
c
c
c
c
c
c
c
c
c
c
c
c
c
c
c
c
c
c
c
c
c
c
c
c
c
c
c
c
c
c
c
c
c
c
c
c
c
c
c
c
c
c
c
c
b
b
b
b
a
a
a
"}
(31,1,1) = {"
a
a
a
Q
Q
P
P
P
P
m
m
m
P
P
Q
Q
c
c
c
c
c
c
c
c
c
c
c
c
c
c
c
c
c
c
c
c
c
c
c
c
c
c
c
c
c
c
c
c
c
c
c
c
c
c
c
c
c
c
c
c
c
c
c
c
c
c
c
c
c
c
c
c
c
c
c
c
c
c
c
c
c
c
c
c
c
c
c
c
c
c
c
c
c
b
b
b
b
a
a
a
"}
(32,1,1) = {"
a
a
a
Q
Q
Q
Q
Q
Q
Q
Q
Q
Q
Q
Q
c
c
c
c
c
c
c
c
c
c
c
c
c
c
c
c
c
c
c
c
c
c
c
c
c
c
c
c
c
c
c
c
c
c
c
c
c
c
c
c
c
c
c
c
c
c
c
c
c
c
c
c
c
c
c
c
c
c
c
c
c
c
c
c
c
c
c
c
c
c
c
c
c
c
c
c
c
c
b
b
b
b
a
a
a
"}
(33,1,1) = {"
a
a
a
Q
Q
b
b
v
v
v
v
v
v
v
v
v
v
v
v
v
v
v
v
v
v
v
v
v
v
v
v
v
v
v
v
v
v
v
v
v
v
v
v
v
v
v
v
v
v
v
v
v
v
v
v
v
v
v
c
c
c
c
c
c
c
c
c
c
c
c
c
c
c
c
c
c
c
c
c
c
c
c
c
c
c
c
c
c
c
c
c
c
c
b
b
b
b
a
a
a
"}
(34,1,1) = {"
a
a
a
Q
Q
b
b
v
v
v
v
v
v
v
v
v
v
v
v
v
v
v
v
v
v
v
v
v
v
v
v
v
v
v
v
v
v
v
v
v
v
v
v
v
v
v
v
v
v
v
v
v
v
v
v
v
v
v
c
c
c
c
c
c
c
c
c
c
c
c
c
c
c
c
c
c
c
c
c
c
c
c
c
c
c
c
c
c
c
c
c
c
c
b
b
b
b
a
a
a
"}
(35,1,1) = {"
a
a
a
b
b
b
b
v
v
v
v
v
v
v
v
v
v
v
v
v
v
v
v
v
v
v
v
v
v
v
v
v
v
v
v
v
v
v
v
v
v
v
v
v
v
v
v
v
v
v
v
v
v
v
v
v
v
v
c
c
c
c
c
c
c
c
c
c
c
c
c
c
c
c
c
c
c
c
c
c
c
c
c
c
c
c
c
c
c
c
c
c
c
b
b
b
b
a
a
a
"}
(36,1,1) = {"
a
a
a
b
b
b
b
v
v
v
v
v
v
v
v
v
v
v
v
v
v
v
v
v
v
v
v
v
v
v
v
v
v
v
v
v
v
v
v
v
v
v
v
v
v
v
v
v
v
v
v
v
v
v
v
v
v
v
c
c
c
c
c
c
c
c
c
c
c
c
c
c
c
c
c
c
c
c
c
c
c
c
c
c
c
c
c
c
c
c
c
c
c
b
b
b
b
a
a
a
"}
(37,1,1) = {"
a
a
a
b
b
b
b
v
v
v
v
v
v
v
v
v
v
v
v
v
v
v
v
v
v
v
v
v
v
v
v
v
v
v
v
v
v
v
v
v
v
v
v
v
v
v
v
v
v
v
v
v
v
v
v
v
v
v
c
c
c
c
c
c
c
c
c
c
c
c
c
c
c
c
c
c
c
c
c
c
c
c
c
c
c
c
c
c
c
c
c
c
c
b
b
b
b
a
a
a
"}
(38,1,1) = {"
a
a
a
b
b
b
b
v
v
v
v
v
v
v
v
v
v
v
v
v
v
v
v
v
v
v
v
v
v
v
v
v
v
v
v
v
v
v
v
v
v
v
v
v
v
v
v
v
v
v
v
v
v
v
v
v
v
v
c
c
c
c
c
c
c
c
c
c
c
c
c
c
c
c
c
c
c
c
c
c
c
c
c
c
c
c
c
c
c
c
c
c
c
b
b
b
b
a
a
a
"}
(39,1,1) = {"
a
a
a
b
b
b
b
v
v
v
v
v
v
v
v
v
v
v
v
v
v
v
v
v
v
v
v
v
v
v
v
v
v
v
v
v
v
v
v
v
v
v
v
v
v
v
v
v
v
v
v
v
v
v
v
v
v
v
c
c
c
c
c
c
c
c
c
c
c
c
c
c
c
c
c
c
c
c
c
c
c
c
c
c
c
c
c
c
c
c
c
c
c
b
b
b
b
a
a
a
"}
(40,1,1) = {"
a
a
a
b
b
b
b
v
v
v
v
v
v
v
v
v
v
v
v
v
v
v
v
v
v
v
v
v
v
v
v
v
v
v
v
v
v
v
v
v
v
v
v
v
v
v
v
v
v
v
v
v
v
v
v
v
v
v
c
c
c
c
c
c
c
c
c
c
c
c
c
c
c
c
c
c
c
c
c
c
c
c
c
c
c
c
c
c
c
c
c
c
c
b
b
b
b
a
a
a
"}
(41,1,1) = {"
a
a
a
b
b
b
b
v
v
v
v
v
v
v
v
v
v
v
v
v
v
v
v
v
v
v
v
v
v
v
v
v
v
v
v
v
v
v
v
v
v
v
v
v
v
v
v
v
v
v
v
v
v
v
v
v
v
v
c
c
c
c
c
c
c
c
c
c
c
c
c
c
c
c
c
c
c
c
c
c
c
c
c
c
c
c
c
c
c
c
c
c
c
b
b
b
b
a
a
a
"}
(42,1,1) = {"
a
a
a
b
b
b
b
v
v
v
v
v
v
v
v
v
v
v
v
v
v
v
v
v
v
v
v
v
v
v
v
v
v
v
v
v
v
v
v
v
v
v
v
v
v
v
v
v
v
v
v
v
v
v
v
v
v
v
c
c
c
c
c
c
c
c
c
c
c
c
c
c
c
c
c
c
c
c
c
c
c
c
c
c
c
c
c
c
c
c
c
c
c
b
b
b
b
a
a
a
"}
(43,1,1) = {"
a
a
a
b
b
b
b
v
v
v
v
v
v
v
v
v
v
v
v
v
v
v
v
v
v
v
v
v
v
v
v
v
v
v
v
v
v
v
v
v
v
v
v
v
v
v
v
v
v
v
v
v
v
v
v
v
v
v
c
c
c
c
c
c
c
c
c
c
c
c
c
c
c
c
c
c
c
c
c
c
c
c
c
c
c
c
c
c
c
c
c
c
c
b
b
b
b
a
a
a
"}
(44,1,1) = {"
a
a
a
b
b
b
b
v
v
v
v
v
v
v
v
v
v
v
v
v
v
v
v
v
v
v
v
v
v
v
v
v
v
v
v
v
v
v
v
v
v
v
v
v
v
v
v
v
v
v
v
v
v
v
v
v
v
v
c
c
c
c
c
c
c
c
c
c
c
c
c
c
c
c
c
c
c
c
c
c
c
c
c
c
c
c
c
c
c
c
c
c
c
b
b
b
b
a
a
a
"}
(45,1,1) = {"
a
a
a
b
b
b
b
v
v
v
v
v
v
v
v
v
v
v
v
v
v
v
v
v
v
v
v
v
v
v
v
v
v
v
v
v
v
v
v
v
v
v
v
v
v
v
v
v
v
v
v
v
v
v
v
v
v
v
c
c
c
c
c
c
c
c
c
c
c
c
c
c
c
c
c
c
c
c
c
c
c
c
c
c
c
c
c
c
c
c
c
c
c
b
b
b
b
a
a
a
"}
(46,1,1) = {"
a
a
a
b
b
b
b
v
v
v
v
v
v
v
v
v
v
v
v
v
v
v
v
v
v
v
v
v
v
v
v
v
v
v
v
v
v
v
v
v
v
v
v
v
v
v
v
v
v
v
v
v
v
v
v
v
v
v
c
c
c
c
c
c
c
c
c
c
c
c
c
c
c
c
c
c
c
c
c
c
c
c
c
c
c
c
c
c
c
c
c
c
c
b
b
b
b
a
a
a
"}
(47,1,1) = {"
a
a
a
b
b
b
b
v
v
v
v
v
v
v
v
v
v
v
v
v
v
v
v
v
v
v
v
v
v
v
v
v
v
v
v
v
v
v
v
v
v
v
v
v
v
v
v
v
v
v
v
v
v
v
v
v
v
v
c
c
c
c
c
c
c
c
c
c
c
c
c
c
c
c
c
c
c
c
c
c
c
c
c
c
c
c
c
c
c
c
c
c
c
b
b
b
b
a
a
a
"}
(48,1,1) = {"
a
a
a
b
b
b
b
v
v
v
v
v
v
v
v
v
v
v
v
v
v
v
v
v
v
v
v
v
v
v
v
v
v
v
v
v
v
v
v
v
v
v
v
v
v
v
v
v
v
v
v
v
v
v
v
v
v
v
c
c
c
c
c
c
c
c
c
c
c
c
c
c
c
c
c
c
c
c
c
c
c
c
c
c
c
c
c
c
c
c
c
c
c
b
b
b
b
a
a
a
"}
(49,1,1) = {"
a
a
a
b
b
b
b
v
v
v
v
v
v
v
v
v
v
v
v
v
v
v
v
v
v
v
v
v
v
v
v
v
v
v
v
v
v
v
v
v
v
v
v
v
v
v
v
v
v
v
v
v
v
v
v
v
v
v
c
c
c
c
c
c
c
c
c
c
c
c
c
c
c
c
c
c
c
c
c
c
c
c
c
c
c
c
c
c
c
c
c
c
c
b
b
b
b
a
a
a
"}
(50,1,1) = {"
a
a
a
b
b
b
b
v
v
v
v
v
v
v
v
v
v
v
v
v
v
v
v
v
v
v
v
v
v
v
v
v
v
v
v
v
v
v
v
v
v
v
v
v
v
v
v
v
v
v
v
v
v
v
v
v
v
v
c
c
c
c
c
c
c
c
c
c
c
c
c
c
c
c
c
c
c
c
c
c
c
c
c
c
c
c
c
c
c
c
c
c
c
b
b
b
b
a
a
a
"}
(51,1,1) = {"
a
a
a
b
b
b
b
v
v
v
v
v
v
v
v
v
v
v
v
v
v
v
v
v
v
v
v
v
v
v
v
v
v
v
v
v
v
v
v
v
v
v
v
v
v
v
v
v
v
v
v
v
v
v
v
v
v
v
c
c
c
c
c
c
c
c
c
c
c
c
c
c
c
c
c
c
c
c
c
c
c
c
c
c
c
c
c
c
c
c
c
c
c
b
b
b
b
a
a
a
"}
(52,1,1) = {"
a
a
a
b
b
b
b
v
v
v
v
v
v
v
v
v
v
v
v
v
v
v
v
v
v
v
v
v
v
v
v
v
v
v
v
v
v
v
v
v
v
v
v
v
v
v
v
v
v
v
v
v
v
v
v
v
v
v
c
c
c
c
c
c
c
c
c
c
c
c
c
c
c
c
c
c
c
c
c
c
c
c
c
c
c
c
c
c
c
c
c
c
c
b
b
b
b
a
a
a
"}
(53,1,1) = {"
a
a
a
b
b
b
b
v
v
v
v
v
v
v
v
v
v
v
v
v
v
v
v
v
v
v
v
v
v
v
v
v
v
v
v
v
v
v
v
v
v
v
v
v
v
v
v
v
v
v
v
v
v
v
v
v
v
v
c
c
c
c
c
c
c
c
c
c
c
c
c
c
c
c
c
c
c
c
c
c
c
c
c
c
c
c
c
c
c
c
c
c
c
b
b
b
b
a
a
a
"}
(54,1,1) = {"
a
a
a
b
b
b
b
v
v
v
v
v
v
v
v
v
v
v
v
v
v
v
v
v
v
v
v
v
v
v
v
v
v
v
v
v
v
v
v
v
v
v
v
v
v
v
v
v
v
v
v
v
v
v
v
v
v
v
c
c
c
c
c
c
c
c
c
c
c
c
c
c
c
c
c
c
c
c
c
c
c
c
c
c
c
c
c
c
c
c
c
c
c
b
b
b
b
a
a
a
"}
(55,1,1) = {"
a
a
a
b
b
b
b
v
v
v
v
v
v
v
v
v
v
v
v
v
v
v
v
v
v
v
v
v
v
v
v
v
v
v
v
v
v
v
v
v
v
v
v
v
v
v
v
v
v
v
v
v
v
v
v
v
v
v
c
c
c
c
c
c
c
c
c
c
c
c
c
c
c
c
c
c
c
c
c
c
c
c
c
c
c
c
c
c
c
c
c
c
c
b
b
b
b
a
a
a
"}
(56,1,1) = {"
a
a
a
b
b
b
b
v
v
v
v
v
v
v
v
v
v
v
v
v
v
v
v
v
v
v
v
v
v
v
v
v
v
v
v
v
v
v
v
v
v
v
v
v
v
v
v
v
v
v
v
v
v
v
v
v
v
v
c
c
c
c
c
c
c
c
c
c
c
c
c
c
c
c
c
c
c
c
c
c
c
c
c
c
c
c
c
c
c
c
c
c
c
b
b
b
b
a
a
a
"}
(57,1,1) = {"
a
a
a
b
b
b
b
v
v
v
v
v
v
v
v
v
v
v
v
v
v
v
v
v
v
v
v
v
v
v
v
v
v
v
v
v
v
v
v
v
v
v
v
v
v
v
v
v
v
v
v
v
v
v
v
v
v
v
c
c
c
c
c
c
c
c
c
c
c
c
c
c
c
c
c
c
c
c
c
c
c
c
c
c
c
c
c
c
c
c
c
c
c
b
b
b
b
a
a
a
"}
(58,1,1) = {"
a
a
a
b
b
b
b
v
v
v
v
v
v
v
v
v
v
v
v
v
v
v
v
v
v
v
v
v
v
v
v
v
v
v
v
v
v
v
v
v
v
v
v
v
v
v
v
v
v
v
v
v
v
v
v
v
v
v
c
c
c
c
c
c
c
c
c
c
c
c
c
c
c
c
c
c
c
c
c
c
c
c
c
c
c
c
c
c
c
c
c
c
c
b
b
b
b
a
a
a
"}
(59,1,1) = {"
a
a
a
b
b
b
b
v
v
v
v
v
v
v
v
v
v
v
v
v
v
v
v
v
v
v
v
v
v
v
v
v
v
v
v
v
v
v
v
v
v
v
v
v
v
v
v
v
v
v
v
v
v
v
v
v
v
v
c
c
c
c
c
c
c
c
c
c
c
c
c
c
c
c
c
c
c
c
c
c
c
c
c
c
c
c
c
c
c
c
c
c
c
b
b
b
b
a
a
a
"}
(60,1,1) = {"
a
a
a
b
b
b
b
v
v
v
v
v
v
v
v
v
v
v
v
v
v
v
v
v
v
v
v
v
v
v
v
v
v
v
v
v
v
v
v
v
v
v
v
v
v
v
v
v
v
v
v
v
v
v
v
v
v
v
c
c
c
c
c
c
c
c
c
c
c
c
c
c
c
c
c
c
c
c
c
c
c
c
c
c
c
c
c
c
c
c
c
c
c
b
b
b
b
a
a
a
"}
(61,1,1) = {"
a
a
a
b
b
b
b
v
v
v
v
v
v
v
v
v
v
v
v
v
v
v
v
v
v
v
v
v
v
v
v
v
v
v
v
v
v
v
v
v
v
v
v
v
v
v
v
v
v
v
v
v
v
v
v
v
v
v
c
c
c
c
c
c
c
c
c
c
c
c
c
c
c
c
c
c
c
c
c
c
c
c
c
c
c
c
c
c
c
c
c
c
c
b
b
b
b
a
a
a
"}
(62,1,1) = {"
a
a
a
b
b
b
b
v
v
v
v
v
v
v
v
v
v
v
v
v
v
v
v
v
v
v
v
v
v
v
v
v
v
v
v
v
v
v
v
v
v
v
v
v
v
v
v
v
v
v
v
v
v
v
v
v
v
v
c
c
c
c
c
c
c
c
c
c
c
c
c
c
c
c
c
c
c
c
c
c
c
c
c
c
c
c
c
c
c
c
c
c
c
b
b
b
b
a
a
a
"}
(63,1,1) = {"
a
a
a
b
b
b
b
v
v
v
v
v
v
v
v
v
v
v
v
v
v
v
v
v
v
v
v
v
v
v
v
v
v
v
v
v
v
v
v
v
v
v
v
v
v
v
v
v
v
v
v
v
v
v
v
v
v
v
c
c
c
c
c
c
c
c
c
c
c
c
c
c
c
c
c
c
c
c
c
c
c
c
c
c
c
c
c
c
c
c
c
c
c
b
b
b
b
a
a
a
"}
(64,1,1) = {"
a
a
a
b
b
b
b
v
v
v
v
v
v
v
v
v
v
v
v
v
v
v
v
v
v
v
v
v
v
v
v
v
v
v
v
v
v
v
v
v
v
v
v
v
v
v
v
v
v
v
v
v
v
v
v
v
v
v
c
c
c
c
c
c
c
c
c
c
c
c
c
c
c
c
c
c
c
c
c
c
c
c
c
c
c
c
c
c
c
c
c
c
c
b
b
b
b
a
a
a
"}
(65,1,1) = {"
a
a
a
b
b
b
b
v
v
v
v
v
v
v
v
v
v
v
v
v
v
v
v
v
v
v
v
v
v
v
v
v
v
v
v
v
v
v
v
v
v
v
v
v
v
v
v
v
v
v
v
v
v
v
v
v
v
v
c
c
c
c
c
c
c
c
c
c
c
c
c
c
c
c
c
c
c
c
c
c
c
c
c
c
c
c
c
c
c
c
c
c
c
b
b
b
b
a
a
a
"}
(66,1,1) = {"
a
a
a
b
b
b
b
v
v
v
v
v
v
v
v
v
v
v
v
v
v
v
v
v
v
v
v
v
v
v
v
v
v
v
v
v
v
v
v
v
v
v
v
v
v
v
v
v
v
v
v
v
v
v
v
v
v
v
c
c
c
c
c
c
c
c
c
c
c
c
c
c
c
c
c
c
c
c
c
c
c
c
c
c
c
c
c
c
c
c
c
c
c
b
b
b
b
a
a
a
"}
(67,1,1) = {"
a
a
a
b
b
b
b
v
v
v
v
v
v
v
v
v
v
v
v
v
v
v
v
v
v
v
v
v
v
v
v
v
v
v
v
v
v
v
v
v
v
v
v
v
v
v
v
v
v
v
v
v
v
v
v
v
v
v
c
c
c
c
c
c
c
c
c
c
c
c
c
c
c
c
c
c
c
c
c
c
c
c
c
c
c
c
c
c
c
c
c
c
c
b
b
b
b
a
a
a
"}
(68,1,1) = {"
a
a
a
b
b
b
b
v
v
v
v
v
v
v
v
v
v
v
v
v
v
v
v
v
v
v
v
v
v
v
v
v
v
v
v
v
v
v
v
v
v
v
v
v
v
v
v
v
v
v
v
v
v
v
v
v
v
v
c
c
c
c
c
c
c
c
c
c
c
c
c
c
c
c
c
c
c
c
c
c
c
c
c
c
c
c
c
c
c
c
c
c
c
b
b
b
b
a
a
a
"}
(69,1,1) = {"
a
a
a
b
b
b
b
v
v
v
v
v
v
v
v
v
v
v
v
v
v
v
v
v
v
v
v
v
v
v
v
v
v
v
v
v
v
v
v
v
v
v
v
v
v
v
v
v
v
v
v
v
v
v
v
v
v
v
c
c
c
c
c
c
c
c
c
c
c
c
c
c
c
c
c
c
c
c
c
c
c
c
c
c
c
c
c
c
c
c
c
c
c
b
b
b
b
a
a
a
"}
(70,1,1) = {"
a
a
a
b
b
b
b
v
v
v
v
v
v
v
v
v
v
v
v
v
v
v
v
v
v
v
v
v
v
v
v
v
v
v
v
v
v
v
v
v
v
v
v
v
v
v
v
v
v
v
v
v
v
v
t
t
t
t
C
C
C
C
C
C
C
C
C
C
C
C
c
c
c
c
c
c
c
c
c
c
c
c
c
c
c
c
c
c
c
c
c
c
c
b
b
b
b
a
a
a
"}
(71,1,1) = {"
a
a
a
b
b
b
b
v
v
v
v
v
v
v
v
v
v
v
v
v
v
v
v
v
v
v
v
v
v
v
v
v
v
v
v
v
v
v
v
v
v
v
v
v
v
v
v
v
v
v
v
v
v
v
t
t
t
t
C
C
C
C
C
C
C
C
C
C
C
C
c
c
c
c
c
c
c
c
c
c
c
c
c
c
c
c
c
c
c
c
c
c
c
b
b
b
b
a
a
a
"}
(72,1,1) = {"
a
a
a
b
b
b
b
v
v
v
v
v
v
v
v
v
v
v
v
v
v
v
v
v
v
v
v
v
v
v
v
v
v
v
v
v
v
v
v
v
v
v
v
v
v
v
v
v
v
v
v
v
v
v
t
t
t
t
C
C
C
C
C
C
C
C
C
C
C
C
c
c
c
c
c
c
c
c
c
c
c
c
c
c
c
c
c
c
c
c
c
c
c
b
b
b
b
a
a
a
"}
(73,1,1) = {"
a
a
a
b
b
b
b
v
v
v
v
v
v
v
v
v
v
v
v
v
v
v
v
v
v
v
v
v
v
v
v
v
v
v
v
v
v
v
v
v
v
v
v
v
v
v
v
v
v
v
v
v
v
v
t
t
t
t
C
C
C
C
C
C
C
C
C
C
C
C
c
c
c
c
c
c
c
c
c
c
c
c
c
c
c
c
c
c
c
c
c
c
c
b
b
b
b
a
a
a
"}
(74,1,1) = {"
a
a
a
b
b
b
b
v
v
v
v
v
v
v
v
v
v
v
v
v
v
v
v
v
v
v
v
v
v
v
v
v
v
v
v
v
v
v
v
v
v
v
v
v
v
v
v
v
v
v
v
v
v
v
t
t
t
t
C
C
C
C
C
C
C
C
C
C
C
C
c
c
c
c
c
c
o
o
o
o
o
o
o
o
o
o
o
o
o
o
o
o
o
b
b
b
b
a
a
a
"}
(75,1,1) = {"
a
a
a
b
b
b
b
v
v
v
v
v
v
v
v
v
v
v
v
v
v
v
v
v
v
v
v
v
v
v
v
v
v
v
v
v
v
v
v
v
v
v
v
v
v
v
v
v
v
v
v
v
v
v
t
t
t
t
C
C
C
C
C
C
C
C
C
C
C
C
c
c
c
c
c
c
o
o
o
o
o
o
o
o
o
o
o
o
o
o
o
o
o
b
b
b
b
a
a
a
"}
(76,1,1) = {"
a
a
a
b
b
b
b
v
v
v
v
v
v
v
v
v
v
v
v
v
v
v
v
v
v
v
v
v
v
v
v
v
v
v
v
v
v
v
v
v
v
v
v
v
v
v
v
v
v
v
v
v
v
v
t
t
t
t
C
C
C
C
C
C
C
C
C
C
C
C
c
c
c
c
c
c
o
o
o
o
o
o
o
o
o
o
o
o
o
o
o
o
o
b
b
b
b
a
a
a
"}
(77,1,1) = {"
a
a
a
b
b
b
b
v
v
v
v
v
v
v
v
v
v
v
v
v
v
v
v
v
v
v
v
v
v
v
v
v
v
v
v
v
v
v
v
v
v
v
v
v
v
v
v
v
v
v
v
v
v
v
t
t
t
t
H
H
C
C
C
C
C
C
C
C
C
C
c
c
c
c
c
c
o
o
o
e
f
f
f
f
f
f
f
f
e
o
o
o
o
b
b
b
b
a
a
a
"}
(78,1,1) = {"
a
a
a
b
b
b
b
v
v
v
v
v
v
v
v
v
v
v
v
v
v
v
v
v
v
v
v
v
v
v
v
v
v
v
v
v
v
v
v
v
v
v
v
v
v
v
v
v
v
v
v
v
v
v
t
t
t
t
H
H
C
C
C
C
C
C
C
C
C
C
c
c
c
c
c
c
o
o
o
e
g
g
g
g
g
j
g
g
e
o
o
o
o
b
b
b
b
a
a
a
"}
(79,1,1) = {"
a
a
a
b
b
b
b
v
v
v
v
v
v
v
v
v
v
v
v
v
v
v
v
v
v
v
v
v
v
v
v
v
v
v
v
v
v
v
v
v
v
v
v
v
v
v
v
v
v
v
v
v
v
v
t
t
t
t
H
H
C
C
C
C
C
C
C
C
C
C
c
c
c
c
c
c
o
o
o
f
u
g
g
i
g
g
g
g
e
o
o
o
o
b
b
b
b
a
a
a
"}
(80,1,1) = {"
a
a
a
b
b
b
b
v
v
v
v
v
v
v
v
v
v
v
v
v
v
v
v
v
v
v
v
v
v
v
v
v
v
v
v
v
v
v
v
v
v
v
v
v
v
v
v
v
v
v
v
v
v
v
t
t
t
t
C
C
C
C
C
C
C
C
C
C
C
C
c
c
c
c
c
c
o
o
o
f
w
g
g
Y
g
n
g
A
e
o
o
o
o
b
b
b
b
a
a
a
"}
(81,1,1) = {"
a
a
a
b
b
b
b
v
v
v
v
v
v
v
v
v
v
v
v
v
v
v
v
v
v
v
v
v
v
v
v
v
v
v
v
v
v
v
v
v
v
v
v
v
v
v
v
v
v
v
v
v
v
v
t
t
t
t
C
C
C
C
C
C
C
C
C
C
C
C
c
c
c
c
c
c
o
o
o
e
q
g
g
g
i
g
g
g
e
o
o
o
o
b
b
b
b
a
a
a
"}
(82,1,1) = {"
a
a
a
b
b
b
b
v
v
v
v
v
v
v
v
v
v
v
v
v
v
v
v
v
v
v
v
v
v
v
v
v
v
v
v
v
v
v
v
v
v
v
v
v
v
v
v
v
v
v
v
v
v
v
t
t
t
t
C
C
C
C
C
C
C
C
C
C
C
C
c
c
c
c
c
c
o
o
o
e
J
g
Y
g
g
A
h
A
e
O
O
O
O
b
b
b
b
a
a
a
"}
(83,1,1) = {"
a
a
a
b
b
b
b
v
v
v
v
v
v
v
v
v
v
v
v
v
v
v
v
v
v
v
v
v
v
v
v
v
v
v
v
v
v
v
v
v
v
v
v
v
v
v
v
v
v
v
v
v
v
v
t
t
t
t
C
C
C
C
C
C
C
C
C
C
C
C
c
c
c
c
c
c
o
o
o
e
E
g
i
g
g
i
g
g
e
e
O
O
O
b
b
b
b
a
a
a
"}
(84,1,1) = {"
a
a
a
b
b
b
b
v
v
v
v
v
v
v
v
v
v
v
v
v
v
v
v
v
v
v
v
v
v
v
v
v
v
v
v
v
v
v
v
v
v
v
v
v
v
v
v
v
v
v
v
v
v
v
t
t
t
t
C
C
C
C
C
C
C
C
C
C
C
C
c
c
c
c
c
c
o
o
o
f
Z
g
g
h
g
r
Y
g
e
O
O
O
O
b
b
b
b
a
a
a
"}
(85,1,1) = {"
a
a
a
b
b
b
b
v
v
v
v
v
v
v
v
v
v
v
v
v
v
v
v
v
v
v
v
v
v
v
v
v
v
v
v
v
v
v
v
v
v
v
v
v
v
v
v
v
v
v
v
v
v
v
t
t
t
t
C
C
C
C
C
C
C
C
C
C
C
C
c
c
c
c
c
c
o
o
o
f
g
g
Y
g
g
g
g
K
e
O
O
O
O
b
b
b
b
a
a
a
"}
(86,1,1) = {"
a
a
a
b
b
b
b
v
v
v
v
v
v
v
v
v
v
v
v
v
v
v
v
v
v
v
v
v
v
v
v
v
v
v
v
v
v
v
v
v
v
v
v
v
v
v
v
v
v
v
v
v
v
v
t
t
t
t
C
C
C
C
C
C
C
C
C
C
C
C
c
c
c
c
c
c
o
o
o
e
L
g
g
d
g
g
g
K
e
O
O
O
O
b
b
b
b
a
a
a
"}
(87,1,1) = {"
a
a
a
b
b
b
b
v
v
v
v
v
v
v
v
v
v
v
v
v
v
v
v
v
v
v
v
v
v
v
v
v
v
v
v
v
v
v
v
v
v
v
v
v
v
v
v
v
v
v
v
v
v
v
t
t
t
t
C
C
C
C
C
C
C
C
C
C
C
C
c
c
c
c
c
c
o
o
o
e
e
e
e
e
e
e
e
e
e
O
O
O
O
b
b
b
b
a
a
a
"}
(88,1,1) = {"
a
a
a
b
b
b
b
v
v
v
v
v
v
v
v
v
v
v
v
v
v
v
v
v
v
v
v
v
v
v
v
v
v
v
v
v
v
v
v
v
v
v
v
v
v
v
v
v
v
v
v
v
v
v
v
v
v
v
c
c
c
c
c
c
c
c
c
c
c
c
c
c
c
c
c
c
o
o
O
O
O
O
O
O
O
O
O
O
O
O
O
O
O
b
b
b
b
a
a
a
"}
(89,1,1) = {"
a
a
a
b
b
b
b
v
v
v
v
v
v
v
v
v
v
v
v
v
v
v
v
v
v
v
v
v
v
v
v
v
v
v
v
v
v
v
v
v
v
v
v
v
v
v
v
v
v
v
v
v
v
v
v
v
v
v
c
c
c
c
c
c
c
c
c
c
c
c
c
c
c
c
c
c
o
o
O
O
O
O
O
O
O
O
O
O
O
O
O
O
O
b
b
b
b
a
a
a
"}
(90,1,1) = {"
a
a
a
b
b
b
b
v
v
v
v
v
v
v
v
v
v
v
v
v
v
v
v
v
v
v
v
v
v
v
v
v
v
v
v
v
v
v
v
v
v
v
v
v
v
v
v
v
v
v
v
v
v
v
v
v
v
v
c
c
c
c
c
c
c
c
c
c
c
c
c
c
c
c
c
c
o
o
O
O
O
O
O
O
O
O
O
O
O
O
O
O
O
b
b
b
b
a
a
a
"}
(91,1,1) = {"
a
a
a
b
b
b
b
v
v
v
v
v
v
v
v
v
v
v
v
v
v
v
v
v
v
v
v
v
v
v
v
v
v
v
v
v
v
v
v
v
v
v
v
v
v
v
v
v
v
v
v
v
v
v
v
v
v
v
c
c
c
c
c
c
c
c
c
c
c
c
c
c
c
c
c
c
o
o
o
o
o
O
O
O
O
O
O
O
O
O
O
O
O
b
b
b
b
a
a
a
"}
(92,1,1) = {"
a
a
a
b
b
b
b
v
v
v
v
v
v
v
v
v
v
v
v
v
v
v
v
v
v
v
v
v
v
v
v
v
v
v
v
v
v
v
v
v
v
v
v
v
v
v
v
v
v
v
v
v
v
v
v
v
v
v
c
c
c
c
c
c
c
c
c
c
c
c
c
c
c
c
c
c
o
o
o
o
o
O
O
O
O
O
O
O
O
O
O
O
O
b
b
b
b
a
a
a
"}
(93,1,1) = {"
a
a
a
b
b
b
b
v
v
v
v
v
v
v
v
v
v
v
v
v
v
v
v
v
v
v
v
v
v
v
v
v
v
v
v
v
v
v
v
v
v
v
v
v
v
v
v
v
v
v
v
v
v
v
v
v
v
v
c
c
c
c
c
c
c
c
c
c
c
c
c
c
c
c
c
c
o
o
o
o
o
O
O
O
O
O
O
O
O
O
O
O
O
b
b
b
b
a
a
a
"}
(94,1,1) = {"
a
a
a
b
b
b
b
b
b
b
b
b
b
b
b
b
b
b
b
b
b
b
b
b
b
b
b
b
b
b
b
b
b
b
b
b
b
b
b
b
b
b
b
b
b
b
b
b
b
b
b
b
b
b
b
b
b
b
b
b
b
b
b
b
b
b
b
b
b
b
b
b
b
b
b
b
b
b
b
b
b
b
b
b
b
b
b
b
b
b
b
b
b
b
b
b
b
a
a
a
"}
(95,1,1) = {"
a
a
a
b
b
b
b
b
b
b
b
b
b
b
b
b
b
b
b
b
b
b
b
b
b
b
b
b
b
b
b
b
b
b
b
b
b
b
b
b
b
b
b
b
b
b
b
b
b
b
b
b
b
b
b
b
b
b
b
b
b
b
b
b
b
b
b
b
b
b
b
b
b
b
b
b
b
b
b
b
b
b
b
b
b
b
b
b
b
b
b
b
b
b
b
b
b
a
a
a
"}
(96,1,1) = {"
a
a
a
b
b
b
b
b
b
b
b
b
b
b
b
b
b
b
b
b
b
b
b
b
b
b
b
b
b
b
b
b
b
b
b
b
b
b
b
b
b
b
b
b
b
b
b
b
b
b
b
b
b
b
b
b
b
b
b
b
b
b
b
b
b
b
b
b
b
b
b
b
b
b
b
b
b
b
b
b
b
b
b
b
b
b
b
b
b
b
b
b
b
b
b
b
b
a
a
a
"}
(97,1,1) = {"
a
a
a
b
b
b
b
b
b
b
b
b
b
b
b
b
b
b
b
b
b
b
b
b
b
b
b
b
b
b
b
b
b
b
b
b
b
b
b
b
b
b
b
b
b
b
b
b
b
b
b
b
b
b
b
b
b
b
b
b
b
b
b
b
b
b
b
b
b
b
b
b
b
b
b
b
b
b
b
b
b
b
b
b
b
b
b
b
b
b
b
b
b
b
b
b
b
a
a
a
"}
(98,1,1) = {"
a
a
a
a
a
a
a
a
a
a
a
a
a
a
a
a
a
a
a
a
a
a
a
a
a
a
a
a
a
a
a
a
a
a
a
a
a
a
a
a
a
a
a
a
a
a
a
a
a
a
a
a
a
a
a
a
a
a
a
a
a
a
a
a
a
a
a
a
a
a
a
a
a
a
a
a
a
a
a
a
a
a
a
a
a
a
a
a
a
a
a
a
a
a
a
a
a
a
a
a
"}
(99,1,1) = {"
a
a
a
a
a
a
a
a
a
a
a
a
a
a
a
a
a
a
a
a
a
a
a
a
a
a
a
a
a
a
a
a
a
a
a
a
a
a
a
a
a
a
a
a
a
a
a
a
a
a
a
a
a
a
a
a
a
a
a
a
a
a
a
a
a
a
a
a
a
a
a
a
a
a
a
a
a
a
a
a
a
a
a
a
a
a
a
a
a
a
a
a
a
a
a
a
a
a
a
a
"}
(100,1,1) = {"
a
a
a
a
a
a
a
a
a
a
a
a
a
a
a
a
a
a
a
a
a
a
a
a
a
a
a
a
a
a
a
a
a
a
a
a
a
a
a
a
a
a
a
a
a
a
a
a
a
a
a
a
a
a
a
a
a
a
a
a
a
a
a
a
a
a
a
a
a
a
a
a
a
a
a
a
a
a
a
a
a
a
a
a
a
a
a
a
a
a
a
a
a
a
a
a
a
a
a
a
"}
