"a" = (/obj/structure/disposalpipe/segment,/turf/simulated/floor/plating,/area/space)
"b" = (/turf/simulated/floor/planet/jungle/path,/area/space)
"c" = (/turf/simulated/floor/planet/jungle,/area/space)
"d" = (/obj/structure/disposalpipe/segment,/obj/effect/floor_decal/industrial/warning{dir = 1},/turf/simulated/floor/plating,/area/space)
"e" = (/obj/effect/floor_decal/industrial/warning{dir = 5},/turf/simulated/floor/plating,/area/space)
"f" = (/obj/structure/disposalpipe/segment,/obj/effect/floor_decal/industrial/warning,/turf/simulated/floor/plating,/area/space)
"g" = (/obj/effect/floor_decal/industrial/warning{dir = 6},/turf/simulated/floor/plating,/area/space)
"h" = (/obj/structure/disposalpipe/segment{dir = 1; icon_state = "pipe-c"},/turf/simulated/floor/plating,/area/space)
"i" = (/obj/structure/disposalpipe/segment{dir = 4},/turf/simulated/floor/plating,/area/space)
"j" = (/obj/structure/disposalpipe/segment{dir = 2; icon_state = "pipe-c"},/turf/simulated/floor/plating,/area/space)
"k" = (/obj/effect/floor_decal/industrial/warning{dir = 9},/turf/simulated/floor/plating,/area/space)
"l" = (/obj/effect/floor_decal/industrial/warning{dir = 10},/turf/simulated/floor/plating,/area/space)
"m" = (/obj/structure/disposalpipe/segment{dir = 4; icon_state = "pipe-c"},/turf/simulated/floor/plating,/area/space)
"n" = (/obj/structure/disposalpipe/segment{dir = 8; icon_state = "pipe-c"},/turf/simulated/floor/plating,/area/space)
"o" = (/turf/simulated/floor/planet/jungle/med,/area/space)

(1,1,1) = {"
abbcccccccccccccccccccccccbbbbbbbbbbbbcc
debccccccccccccccccccbcbbbbbbbbbbbbbbbcc
fgbccccccccccccccccbbbbbbbbbbbbbbbbbbbcc
accccccccccccccccccbbbbbbbbbbbbbbbbbbccc
acccccccccccccccccbbbbbbbbbbbbbbbbbbbccc
hiijcccccccccbbbbbbbbbbbbbbbbbbbbbbbbccc
cccaccbbbbbbbbbbbbbbbbbbbbbbbbbbbbbbbbcc
cccacbbbbbbbbbbbbbbbbbbbbbbbbbbbbbbbbbcc
cccabbbbbbbbbbbccbbbbbbbbbbbbbbbbbbbbbcc
ccbabbbbbbbbbbbcccbbbbbbbbbbbbbbbbbbbccc
cbbabbbccbccccccbbbbbbbbbbbbbbbbbbbbbccc
cbbabbcccbcccccbbbbbbbbbbbbbbbbbbbbbbccc
bbbabbcccbcccbbbbbbbbbbbbbbbbbbbbbbbbccc
bbbabbbbbbbbbbbbbbbbbbbbbbbbbbbbbbbbbccc
bbbabbbbbbbbbbbbbbbbbbbbbbbbbbbbbbbbbbbc
bbbabbbbbbbbbbbbbbbbbbbbbbbbbbbbbbbbcccc
bbbabbbbbbbcbbbbbbbbbbbbbbbbbbbbbbbbcccc
cbbabbcccbbbbbbbcbbbbbbbbbbbbbbbbbbbbccc
cbbabbbccbbbbbcccbbbbbbbbbbbbbbbbbbbbccc
cbbabbbccbbbbbbccbbbbbbbbbbbbbbbbbbbbccc
cbbabbbccbbbbbbccbbbbbbbbbbbbbbbbbcccccc
bbbhijbbbbbbbbbcbbbbbbbbbbbbbbbbbbcccccc
bbbbbhjbbbbbcccccbbbbbbbbbbbbcbbbbcccccc
cccbbbabbbbbccccbbbbbbbbbbbbbccbbccccccc
cccbbbabbbbcccccbbbbbbbbbbbbcccbbccccccc
cccbbbabbbbcccccbbbbbbbbbbbbbccccccccccc
ccccbbabbbbccccccbbbbbbbbbbbbccccccccccc
ccccbbabbbcccccccbbbbbbbbbbbbccccccccccc
ccbbbkdebbbccccbbbbbbbbbbbbbbccccccccccc
ccbbblfgbbcccccbbbbbbbbbbbbbbccccccccccc
cccbbbabbbccccccbbbbbbbbbbbbbccccccccccc
cccbbbabbbccccccbbbbbbbbbbbbcccccccccccc
ccbbminbbbbcccccbbbbbbbbbbbbbbcccccccccc
cbbbabbbbccccccccbbbbbbbbbbbbbccccccccoo
cbbbabbbbbcccccccbbbbbbbbbbbbbccccccccoo
"}
