"a" = (/obj/structure/closet/crate{icon_state = "crateopen"; opened = 1},/obj/item/inflatable/door,/obj/item/inflatable,/obj/item/inflatable,/obj/item/bodybag/cryobag,/obj/item/bodybag/cryobag,/obj/item/bodybag/cryobag,/obj/item/bodybag/cryobag,/obj/item/weapon/tank/emergency/oxygen/double,/obj/item/weapon/tank/emergency/oxygen/double,/obj/item/weapon/tank/emergency/oxygen/double,/obj/item/weapon/tank/emergency/oxygen/double,/turf/simulated/floor/tiled/steel,/area/template_noop)
"b" = (/turf/simulated/floor/tiled/steel,/area/template_noop)
"c" = (/obj/machinery/atmospherics/pipe/simple/hidden/supply,/turf/simulated/floor/tiled/steel,/area/template_noop)
"d" = (/obj/structure/table/standard/flipped/e,/turf/simulated/floor/tiled/steel,/area/template_noop)
"e" = (/obj/structure/grille,/obj/structure/window/reinforced,/obj/structure/window/reinforced{dir = 4},/obj/structure/window/reinforced{dir = 8},/turf/simulated/floor/plating,/area/template_noop)
"f" = (/obj/item/weapon/paper,/turf/simulated/floor/tiled/steel,/area/template_noop)
"g" = (/obj/item/weapon/cigbutt,/turf/simulated/floor/tiled/steel,/area/template_noop)
"h" = (/obj/item/stack/material/cardboard,/turf/simulated/floor/tiled/steel,/area/template_noop)
"i" = (/obj/machinery/atmospherics/unary/vent_pump/on{dir = 1},/turf/simulated/floor/tiled/steel,/area/template_noop)
"j" = (/obj/machinery/door/firedoor,/turf/simulated/floor/tiled/steel,/area/template_noop)
"k" = (/obj/structure/disposalpipe/sortjunction{dir = 8; icon_state = "pipe-j2s"; name = "Quartermaster"; sortType = "Quartermaster"},/turf/simulated/floor/tiled/steel,/area/template_noop)
"l" = (/obj/structure/disposalpipe/segment{dir = 4},/turf/simulated/floor/tiled/steel,/area/template_noop)
"m" = (/obj/structure/disposalpipe/segment{dir = 4},/obj/structure/table/standard/flipped/e,/turf/simulated/floor/tiled/steel,/area/template_noop)
"n" = (/obj/machinery/door/firedoor,/obj/structure/disposalpipe/segment{dir = 4},/turf/simulated/floor/tiled/steel,/area/template_noop)
"o" = (/obj/structure/disposalpipe/segment,/turf/simulated/floor/tiled/steel,/area/template_noop)
"p" = (/obj/item/weapon/material/hatchet/wood,/turf/simulated/floor/tiled/steel,/area/template_noop)
"q" = (/obj/machinery/hologram/holopad,/turf/simulated/floor/tiled/steel,/area/template_noop)
"r" = (/obj/structure/grille,/obj/structure/window/reinforced{dir = 4},/obj/structure/window/reinforced{dir = 8},/obj/structure/window/reinforced{dir = 1},/turf/simulated/floor/plating,/area/template_noop)
"s" = (/obj/structure/disposalpipe/segment{dir = 8; icon_state = "pipe-c"},/obj/machinery/atmospherics/pipe/simple/hidden/scrubbers{dir = 4},/turf/simulated/floor/tiled/steel,/area/template_noop)
"t" = (/obj/machinery/atmospherics/unary/vent_scrubber/on{dir = 8},/turf/simulated/floor/tiled/steel,/area/template_noop)
"u" = (/obj/structure/bed/chair{dir = 8},/turf/simulated/floor/tiled/steel,/area/template_noop)
"v" = (/obj/item/weapon/pen,/turf/simulated/floor/tiled/steel,/area/template_noop)
"w" = (/obj/structure/closet/crate{icon_state = "crateopen"; opened = 1},/obj/structure/closet/crate{icon_state = "crateopen"; opened = 1},/obj/item/weapon/grenade/anforgrenade,/obj/item/weapon/grenade/anforgrenade,/turf/simulated/floor/tiled/steel,/area/template_noop)
"x" = (/obj/item/device/radio/intercom{name = "Station Intercom (General)"; pixel_y = -29},/turf/simulated/floor/tiled/steel,/area/template_noop)
"y" = (/obj/machinery/light{dir = 4},/obj/structure/barricade,/turf/simulated/floor/tiled/steel,/area/template_noop)
"z" = (/turf/simulated/wall,/area/template_noop)
"A" = (/obj/item/weapon/mop,/turf/simulated/floor/tiled/steel,/area/template_noop)
"B" = (/obj/machinery/door/blast/regular{density = 0; icon_state = "pdoor0"; id = "TradingPost"; name = "Trading Post Door"; opacity = 0},/turf/simulated/floor/tiled/steel,/area/template_noop)
"C" = (/obj/structure/grille,/obj/structure/window/reinforced,/obj/structure/window/reinforced{dir = 1},/obj/structure/window/reinforced{dir = 4},/obj/structure/window/reinforced{dir = 8},/turf/simulated/floor/plating,/area/template_noop)
"D" = (/obj/structure/table/reinforced,/obj/machinery/door/window/westleft{dir = 2; name = "Trading Post Desk"},/obj/item/weapon/scissors,/obj/item/weapon/rollingpaper,/obj/item/ammo_magazine/c38,/turf/simulated/floor/tiled/steel,/area/template_noop)
"E" = (/obj/machinery/door/airlock/maintenance{req_access = list(12)},/turf/simulated/floor/plating,/area/template_noop)
"F" = (/obj/machinery/button/remote/blast_door{id = "TradingPost"; name = "Trading Post Door Control"; pixel_x = -28},/turf/simulated/floor/tiled/steel,/area/template_noop)
"G" = (/obj/structure/closet/crate{icon_state = "crateopen"; opened = 1},/obj/item/weapon/shield/riot,/obj/item/weapon/shield/riot,/obj/item/weapon/shield/riot,/obj/item/weapon/storage/box/mines,/turf/simulated/floor/tiled/steel,/area/template_noop)
"H" = (/obj/structure/closet/crate{icon_state = "crateopen"; opened = 1},/obj/item/weapon/hemostat,/obj/item/weapon/cell/high,/turf/simulated/floor/tiled/steel,/area/template_noop)
"I" = (/obj/item/weapon/shiv,/obj/item/weapon/cigbutt,/turf/simulated/floor/plating,/area/template_noop)
"J" = (/obj/item/weapon/caution,/turf/simulated/floor/tiled/steel,/area/template_noop)

(1,1,1) = {"
abcdbef
ghidbjg
kllmlnl
opqdbrb
stbbueb
vbwxyzA
BCDzEzb
FGHzIzJ
"}
