"a" = (/turf/simulated/planet/jungle,/area/jungle)
"b" = (/turf/simulated/planet/jungle/path,/area/jungle)
"c" = (/obj/structure/disposalpipe/segment,/turf/simulated/floor/plating,/area/jungle)
"d" = (/obj/effect/floor_decal/industrial/warning{dir = 9},/turf/simulated/floor/plating,/area/jungle)
"e" = (/obj/structure/disposalpipe/segment,/obj/effect/floor_decal/industrial/warning{dir = 1},/turf/simulated/floor/plating,/area/jungle)
"f" = (/obj/effect/floor_decal/industrial/warning{dir = 5},/turf/simulated/floor/plating,/area/jungle)
"g" = (/obj/effect/floor_decal/industrial/warning{dir = 10},/turf/simulated/floor/plating,/area/jungle)
"h" = (/obj/structure/disposalpipe/segment,/obj/effect/floor_decal/industrial/warning,/turf/simulated/floor/plating,/area/jungle)
"i" = (/obj/effect/floor_decal/industrial/warning{dir = 6},/turf/simulated/floor/plating,/area/jungle)
"j" = (/obj/effect/mine/frag,/turf/simulated/planet/jungle/path,/area/jungle)
"k" = (/obj/structure/disposalpipe/segment{dir = 1; icon_state = "pipe-c"},/obj/effect/mine/frag,/turf/simulated/floor/plating,/area/jungle)
"l" = (/obj/structure/disposalpipe/segment{dir = 4},/obj/effect/mine/frag,/turf/simulated/floor/plating,/area/jungle)
"m" = (/obj/structure/disposalpipe/segment{dir = 2; icon_state = "pipe-c"},/turf/simulated/floor/plating,/area/jungle)
"n" = (/obj/structure/barricade,/turf/simulated/planet/jungle/path,/area/jungle)
"o" = (/turf/simulated/wall/r_wall,/area/jungle)
"p" = (/obj/structure/table/standard/flipped/n,/turf/simulated/floor/tiled,/area/jungle)
"q" = (/turf/simulated/floor/tiled,/area/jungle)
"r" = (/obj/structure/grille,/obj/structure/window/reinforced,/obj/structure/window/reinforced{dir = 4},/obj/structure/window/reinforced{dir = 1},/obj/machinery/door/firedoor/border_only{dir = 2},/obj/structure/window/reinforced{dir = 8},/turf/simulated/floor/plating,/area/jungle)
"s" = (/obj/structure/table/standard,/obj/item/stack/material/steel/fifty,/turf/simulated/floor/tiled,/area/jungle)
"t" = (/obj/item/device/flashlight/lamp/lantern{on = 1},/obj/structure/table/standard,/turf/simulated/floor/tiled,/area/jungle)
"u" = (/obj/machinery/door/airlock/security,/turf/simulated/floor/tiled,/area/jungle)
"v" = (/obj/structure/table/standard,/obj/item/device/flashlight/lamp/lantern{on = 1},/turf/simulated/floor/tiled,/area/jungle)

(1,1,1) = {"
abbcbbbaaaaaaaaa
abbcbbbbaaaaaaaa
abbcbbbbaaaaaaaa
abbcbbbbaaaaaaaa
abbcbbbbaaaaaaaa
abbcbbbbaaaaaaaa
abdefbbbaaaaaaaa
abghibbbbaaaaaaa
bbbcbbbbbaaaaaaa
bbbcbbbbbaaaaaaa
bbbcbbbbbaaaaaaa
bbbcbbbbbbaaaaaa
bbbcbbbbbbbaaaaa
jjjklmbbbbbbaaaa
nnnnncbbbbbbbaaa
opppocbbbbbbbbaa
oqqqocbbbbbbbbba
rqqqrcbbbbbbbbba
osqtocbbbbbbbbba
oouoocbbbbbbbbba
bbbbbcbbbjjjjjba
abbbbcbbbnnnnnba
abbbbcbbbopppoba
abbbbcbbboqqqoba
aaabbcbbbrqqqrba
aaabbcbbbovqqoba
aaabbcbbboouooba
abbbbcbbbbbbbbbb
"}
