"a" = (/turf/simulated/wall,/area/template_noop)
"b" = (/obj/machinery/disposal,/obj/structure/disposalpipe/trunk,/turf/simulated/floor{tag = "icon-neutralcorner (NORTH)"; icon_state = "neutralcorner"; dir = 1},/area/template_noop)
"c" = (/turf/simulated/floor,/area/template_noop)
"d" = (/obj/structure/disposalpipe/segment,/turf/simulated/floor,/area/template_noop)
"e" = (/obj/structure/table/standard,/obj/machinery/recharger,/turf/simulated/floor{tag = "icon-neutralcorner (EAST)"; icon_state = "neutralcorner"; dir = 4},/area/template_noop)
"f" = (/turf/simulated/floor{tag = "icon-neutralcorner (NORTH)"; icon_state = "neutralcorner"; dir = 1},/area/template_noop)
"g" = (/turf/simulated/floor{tag = "icon-neutralcorner (EAST)"; icon_state = "neutralcorner"; dir = 4},/area/template_noop)
"h" = (/obj/machinery/door/firedoor,/turf/simulated/floor{tag = "icon-neutralcorner (NORTH)"; icon_state = "neutralcorner"; dir = 1},/area/template_noop)
"i" = (/obj/structure/disposalpipe/segment,/obj/structure/table/standard/flipped/w,/turf/simulated/floor,/area/template_noop)
"j" = (/obj/machinery/atmospherics/unary/vent_pump/on,/turf/simulated/floor,/area/template_noop)
"k" = (/obj/machinery/hologram/holopad,/obj/structure/disposalpipe/segment,/turf/simulated/floor,/area/template_noop)
"l" = (/obj/structure/table/standard/flipped/e,/turf/simulated/floor,/area/template_noop)
"m" = (/obj/machinery/light{dir = 1},/obj/machinery/door/firedoor,/turf/simulated/floor{tag = "icon-neutralcorner (EAST)"; icon_state = "neutralcorner"; dir = 4},/area/template_noop)
"n" = (/obj/structure/cable{d1 = 4; d2 = 8; icon_state = "4-8"; pixel_y = 0},/obj/machinery/atmospherics/pipe/simple/hidden/supply{dir = 4},/obj/structure/disposalpipe/segment{dir = 4},/obj/machinery/door/firedoor,/turf/simulated/floor,/area/template_noop)
"o" = (/obj/structure/cable{d1 = 4; d2 = 8; icon_state = "4-8"; pixel_y = 0},/obj/machinery/atmospherics/pipe/simple/hidden/supply{dir = 4},/obj/structure/disposalpipe/segment{dir = 4},/turf/simulated/floor,/area/template_noop)
"p" = (/obj/structure/cable{d1 = 4; d2 = 8; icon_state = "4-8"; pixel_y = 0},/obj/machinery/atmospherics/pipe/simple/hidden/supply{dir = 4},/obj/structure/disposalpipe/junction{tag = "icon-pipe-j1 (WEST)"; icon_state = "pipe-j1"; dir = 8},/obj/structure/table/standard/flipped/w,/turf/simulated/floor,/area/template_noop)
"q" = (/obj/structure/cable{d1 = 4; d2 = 8; icon_state = "4-8"; pixel_y = 0},/obj/machinery/atmospherics/pipe/manifold/hidden/supply,/obj/structure/disposalpipe/junction{dir = 8; icon_state = "pipe-j2"},/turf/simulated/floor,/area/template_noop)
"r" = (/obj/machinery/atmospherics/pipe/manifold/hidden/supply{dir = 1},/obj/structure/cable{d1 = 4; d2 = 8; icon_state = "4-8"; pixel_y = 0},/obj/structure/disposalpipe/sortjunction{dir = 8; icon_state = "pipe-j1s"; name = "Botany"; sortType = "Botany"},/turf/simulated/floor,/area/template_noop)
"s" = (/obj/machinery/atmospherics/pipe/simple/hidden/supply{dir = 4},/obj/structure/cable{d1 = 4; d2 = 8; icon_state = "4-8"; pixel_y = 0},/obj/structure/disposalpipe/sortjunction/flipped{dir = 8; sortType = "Drone Fabrication"; name = "Drone Fabrication"},/obj/structure/table/standard/flipped/e,/turf/simulated/floor,/area/template_noop)
"t" = (/obj/machinery/atmospherics/pipe/simple/hidden/supply{dir = 4},/obj/structure/cable{d1 = 4; d2 = 8; icon_state = "4-8"; pixel_y = 0},/obj/structure/disposalpipe/segment{dir = 4},/turf/simulated/floor,/area/template_noop)
"u" = (/obj/machinery/atmospherics/pipe/simple/hidden/supply{dir = 4},/obj/structure/cable{d1 = 4; d2 = 8; icon_state = "4-8"; pixel_y = 0},/obj/structure/disposalpipe/segment{dir = 4},/obj/machinery/door/firedoor,/turf/simulated/floor,/area/template_noop)
"v" = (/obj/machinery/atmospherics/pipe/simple/hidden/scrubbers{dir = 4},/obj/machinery/door/firedoor,/turf/simulated/floor,/area/template_noop)
"w" = (/obj/machinery/atmospherics/pipe/simple/hidden/scrubbers{dir = 4},/turf/simulated/floor{dir = 2; icon_state = "yellowcorner"},/area/template_noop)
"x" = (/obj/machinery/atmospherics/pipe/manifold/hidden/scrubbers{dir = 1},/obj/structure/table/standard/flipped/w,/turf/simulated/floor{dir = 2; icon_state = "yellowcorner"},/area/template_noop)
"y" = (/obj/machinery/atmospherics/unary/vent_scrubber/on{dir = 8},/obj/structure/disposalpipe/segment,/obj/structure/sign/urist/deptsigns/eng{pixel_x = -32; pixel_y = -32},/obj/item/weapon/storage/firstaid/combat,/turf/simulated/floor,/area/template_noop)
"z" = (/obj/machinery/atmospherics/pipe/simple/hidden/supply,/obj/structure/disposalpipe/segment{dir = 4; icon_state = "pipe-c"},/turf/simulated/floor,/area/template_noop)
"A" = (/obj/machinery/camera{c_tag = "Central Hallway South Access"; dir = 1},/obj/structure/disposalpipe/segment{dir = 8; icon_state = "pipe-c"},/obj/structure/table/standard/flipped/e,/turf/simulated/floor{dir = 8; icon_state = "cautioncorner"},/area/template_noop)
"B" = (/obj/machinery/atm{pixel_y = -30},/turf/simulated/floor{dir = 8; icon_state = "cautioncorner"},/area/template_noop)
"C" = (/obj/machinery/door/firedoor,/turf/simulated/floor,/area/template_noop)

(1,1,1) = {"
aabcdeaa
afdcdcga
hcijklcm
nopqrstu
vwxyzABC
"}
