"aa" = (/turf/simulated/wall,/area/hallway/primary/central_one)
"ab" = (/obj/structure/closet/wardrobe/tactical,/obj/item/weapon/gun/projectile/shotgun/doublebarrel,/turf/simulated/floor/reinforced,/area/hallway/primary/central_one)
"ac" = (/obj/machinery/camera{c_tag = "Central Primary Hallway Garden North"},/obj/structure/sign/atmosplaque{desc = "A plaque commemorating the fallen, may they rest in peace, forever asleep amongst the stars. Someone has drawn a picture of a crying badger at the bottom. "; icon_state = "kiddieplaque"; name = "Remembrance Plaque"; pixel_x = 0; pixel_y = 32},/obj/machinery/atmospherics/pipe/simple/hidden/supply{dir = 6},/turf/simulated/floor/reinforced,/area/hallway/primary/central_one)
"ad" = (/obj/machinery/atmospherics/pipe/simple/hidden/supply{dir = 4},/turf/simulated/floor/reinforced,/area/hallway/primary/central_one)
"ae" = (/obj/machinery/atmospherics/pipe/simple/hidden/supply{dir = 9; icon_state = "intact-supply"; tag = "icon-intact (SOUTHWEST)"},/turf/simulated/floor/reinforced,/area/hallway/primary/central_one)
"af" = (/obj/item/weapon/storage/firstaid/regular,/turf/simulated/floor/reinforced,/area/hallway/primary/central_one)
"ag" = (/obj/structure/cable{icon_state = "0-2"; d2 = 2},/obj/machinery/power/apc{cell_type = /obj/item/weapon/cell/high; dir = 1; name = "north bump"; pixel_x = 0; pixel_y = 25},/turf/simulated/floor/reinforced,/area/hallway/primary/central_one)
"ah" = (/obj/structure/sign/atmosplaque{pixel_y = 32},/turf/simulated/floor/reinforced,/area/hallway/primary/central_one)
"ai" = (/obj/structure/closet/wardrobe/tactical,/turf/simulated/floor/reinforced,/area/hallway/primary/central_one)
"aj" = (/obj/machinery/sleeper,/turf/simulated/floor/reinforced,/area/hallway/primary/central_one)
"ak" = (/obj/machinery/atmospherics/pipe/manifold/hidden/supply{dir = 8},/turf/simulated/floor/reinforced,/area/hallway/primary/central_one)
"al" = (/obj/machinery/atmospherics/unary/vent_pump/on{dir = 8},/obj/structure/table/standard/flipped/n,/turf/simulated/floor/reinforced,/area/hallway/primary/central_one)
"am" = (/obj/structure/table/standard/flipped/n,/turf/simulated/floor/reinforced,/area/hallway/primary/central_one)
"an" = (/obj/structure/cable{d1 = 1; d2 = 2; icon_state = "1-2"; pixel_y = 0},/obj/machinery/atmospherics/unary/vent_scrubber/on,/obj/structure/table/standard/flipped/n,/turf/simulated/floor/reinforced,/area/hallway/primary/central_one)
"ao" = (/turf/simulated/floor/reinforced,/area/hallway/primary/central_one)
"ap" = (/obj/item/stack/medical/ointment,/turf/simulated/floor/reinforced,/area/hallway/primary/central_one)
"aq" = (/obj/machinery/atmospherics/pipe/simple/hidden/supply,/obj/item/weapon/storage/firstaid/regular,/turf/simulated/floor/reinforced,/area/hallway/primary/central_one)
"ar" = (/obj/item/weapon/cigbutt,/turf/simulated/floor/reinforced,/area/hallway/primary/central_one)
"as" = (/obj/structure/cable{d1 = 1; d2 = 4; icon_state = "1-4"; tag = ""},/obj/machinery/atmospherics/pipe/simple/hidden/scrubbers{dir = 5},/turf/simulated/floor/reinforced,/area/hallway/primary/central_one)
"at" = (/obj/structure/cable{d1 = 2; d2 = 8; icon_state = "2-8"; tag = ""},/obj/machinery/atmospherics/pipe/simple/hidden/scrubbers{dir = 4},/turf/simulated/floor/reinforced,/area/hallway/primary/central_one)
"au" = (/obj/machinery/atmospherics/pipe/simple/hidden/scrubbers{dir = 10},/turf/simulated/floor/reinforced,/area/hallway/primary/central_one)
"av" = (/obj/structure/table/standard/flipped/w,/turf/simulated/floor/reinforced,/area/hallway/primary/central_one)
"aw" = (/obj/machinery/atmospherics/pipe/simple/hidden/supply,/turf/simulated/floor/reinforced,/area/hallway/primary/central_one)
"ax" = (/obj/structure/cable{d1 = 1; d2 = 2; icon_state = "1-2"; pixel_y = 0},/turf/simulated/floor/reinforced,/area/hallway/primary/central_one)
"ay" = (/obj/machinery/atmospherics/pipe/simple/hidden/scrubbers,/obj/structure/table/standard/flipped/e,/turf/simulated/floor/reinforced,/area/hallway/primary/central_one)
"az" = (/obj/machinery/alarm{dir = 8; icon_state = "alarm0"; pixel_x = 24},/turf/simulated/floor/reinforced,/area/hallway/primary/central_one)
"aA" = (/obj/machinery/atmospherics/pipe/simple/hidden/supply{dir = 4},/obj/structure/table/standard/flipped/w,/turf/simulated/floor/reinforced,/area/hallway/primary/central_one)
"aB" = (/obj/machinery/atmospherics/pipe/simple/hidden/supply{dir = 9; pixel_y = 0},/turf/simulated/floor/reinforced,/area/hallway/primary/central_one)
"aC" = (/obj/item/weapon/storage/firstaid/combat,/obj/item/weapon/storage/firstaid/combat,/turf/simulated/floor/reinforced,/area/hallway/primary/central_one)
"aD" = (/obj/structure/window/phoronreinforced{tag = "icon-phoronrwindow (WEST)"; icon_state = "phoronrwindow"; dir = 8},/obj/structure/window/phoronreinforced{tag = "icon-phoronrwindow (NORTH)"; icon_state = "phoronrwindow"; dir = 1},/obj/structure/assaultshieldgen,/turf/simulated/floor/reinforced,/area/hallway/primary/central_one)
"aE" = (/obj/structure/window/phoronreinforced{tag = "icon-phoronrwindow (EAST)"; icon_state = "phoronrwindow"; dir = 4},/obj/structure/window/phoronreinforced{tag = "icon-phoronrwindow (NORTH)"; icon_state = "phoronrwindow"; dir = 1},/obj/structure/assaultshieldgen,/turf/simulated/floor/reinforced,/area/hallway/primary/central_one)
"aF" = (/obj/item/stack/nanopaste,/turf/simulated/floor/reinforced,/area/hallway/primary/central_one)
"aG" = (/obj/structure/cable{d1 = 1; d2 = 4; icon_state = "1-4"; tag = ""},/turf/simulated/floor/reinforced,/area/hallway/primary/central_one)
"aH" = (/obj/structure/cable{d1 = 4; d2 = 8; icon_state = "4-8"; pixel_y = 0},/obj/machinery/atmospherics/pipe/simple/hidden/scrubbers,/obj/structure/table/standard/flipped/e,/turf/simulated/floor/reinforced,/area/hallway/primary/central_one)
"aI" = (/obj/structure/cable{d1 = 4; d2 = 8; icon_state = "4-8"; pixel_y = 0},/turf/simulated/floor/reinforced,/area/hallway/primary/central_one)
"aJ" = (/obj/item/stack/medical/bruise_pack,/turf/simulated/floor/reinforced,/area/hallway/primary/central_one)
"aK" = (/obj/item/weapon/storage/firstaid/fire,/obj/item/weapon/storage/firstaid/fire,/turf/simulated/floor/reinforced,/area/hallway/primary/central_one)
"aL" = (/obj/structure/window/phoronreinforced,/obj/structure/window/phoronreinforced{tag = "icon-phoronrwindow (WEST)"; icon_state = "phoronrwindow"; dir = 8},/obj/structure/assaultshieldgen,/turf/simulated/floor/reinforced,/area/hallway/primary/central_one)
"aM" = (/obj/structure/window/phoronreinforced,/obj/structure/window/phoronreinforced{tag = "icon-phoronrwindow (EAST)"; icon_state = "phoronrwindow"; dir = 4},/obj/structure/assaultshieldgen,/turf/simulated/floor/reinforced,/area/hallway/primary/central_one)
"aN" = (/obj/item/weapon/storage/firstaid/adv,/obj/item/weapon/storage/firstaid/adv,/turf/simulated/floor/reinforced,/area/hallway/primary/central_one)
"aO" = (/obj/item/weapon/gun/projectile/shotgun/pump,/turf/simulated/floor/reinforced,/area/hallway/primary/central_one)
"aP" = (/obj/machinery/atmospherics/unary/vent_scrubber/on{dir = 4},/turf/simulated/floor/reinforced,/area/hallway/primary/central_one)
"aQ" = (/obj/machinery/atmospherics/pipe/manifold/hidden/scrubbers,/obj/structure/table/standard/flipped/e,/turf/simulated/floor/reinforced,/area/hallway/primary/central_one)
"aR" = (/obj/machinery/atmospherics/pipe/simple/hidden/scrubbers{dir = 4},/obj/machinery/light{dir = 4},/turf/simulated/floor/reinforced,/area/hallway/primary/central_one)
"aS" = (/obj/machinery/camera{c_tag = "Central Primary Hallway Garden Southwest"; dir = 4; network = list("Exodus")},/turf/simulated/floor/reinforced,/area/hallway/primary/central_one)
"aT" = (/obj/item/weapon/storage/toolbox/mechanical,/turf/simulated/floor/reinforced,/area/hallway/primary/central_one)
"aU" = (/obj/machinery/hologram/holopad,/turf/simulated/floor/reinforced,/area/hallway/primary/central_one)
"aV" = (/obj/machinery/camera{c_tag = "Central Primary Hallway Garden South"; dir = 8; network = list("Exodus")},/obj/item/stack/medical/splint,/turf/simulated/floor/reinforced,/area/hallway/primary/central_one)
"aW" = (/obj/structure/table/standard,/obj/machinery/recharger,/turf/simulated/floor/reinforced,/area/hallway/primary/central_one)
"aX" = (/obj/machinery/shieldgen,/turf/simulated/floor/reinforced,/area/hallway/primary/central_one)
"aY" = (/obj/structure/table/standard/flipped/s,/turf/simulated/floor/reinforced,/area/hallway/primary/central_one)
"aZ" = (/obj/structure/table/standard/flipped/s,/obj/item/weapon/storage/box/shotgunammo,/turf/simulated/floor/reinforced,/area/hallway/primary/central_one)
"ba" = (/obj/machinery/atmospherics/unary/vent_pump/on{dir = 4; layer = 2.4},/obj/structure/table/standard/flipped/s,/turf/simulated/floor/reinforced,/area/hallway/primary/central_one)
"bb" = (/obj/machinery/atmospherics/pipe/simple/hidden/supply{dir = 4},/obj/structure/table/standard/flipped/s,/turf/simulated/floor/reinforced,/area/hallway/primary/central_one)
"bc" = (/obj/machinery/atmospherics/pipe/simple/hidden/supply{dir = 10},/turf/simulated/floor/reinforced,/area/hallway/primary/central_one)
"bd" = (/obj/machinery/firealarm{dir = 1; pixel_y = -24},/turf/simulated/floor/reinforced,/area/hallway/primary/central_one)
"be" = (/obj/machinery/newscaster{hitstaken = 1; pixel_x = 0; pixel_y = -32},/turf/simulated/floor/reinforced,/area/hallway/primary/central_one)
"bf" = (/obj/machinery/atmospherics/pipe/simple/hidden/supply,/obj/item/device/radio/intercom{name = "Station Intercom (General)"; pixel_y = -29},/turf/simulated/floor/reinforced,/area/hallway/primary/central_one)

(1,1,1) = {"
aaabacadaeafagahaiaa
ajajakalamamanaoajaj
apaoaqaoaoarasatauao
aoavawaraoaoaoaxayaz
adaAaBaCaDaEaFaGaHaI
aravaJaKaLaMaNaoayao
aoavaOaoaoaoaoaPaQaR
aSaoaoaTaoaUaoaoaoaV
aWaXaoaYaZbabbbcaXaW
aaaWarbdaoaobebfaWaa
"}
