"a" = (/turf/simulated/wall,/area/space)
"b" = (/obj/structure/table/standard/flipped/n,/turf/simulated/floor/carpet,/area/space)
"c" = (/obj/machinery/door/firedoor,/obj/machinery/door/airlock/glass{name = "Library"},/obj/machinery/atmospherics/pipe/simple/hidden/supply,/obj/machinery/atmospherics/pipe/simple/hidden/scrubbers,/turf/simulated/floor/carpet,/area/space)
"d" = (/obj/machinery/bodyscanner{dir = 4},/obj/effect/floor_decal/corner/paleblue/diagonal{tag = "icon-corner_white_diagonal (EAST)"; icon_state = "corner_white_diagonal"; dir = 4},/turf/simulated/floor/tiled/white,/area/space)
"e" = (/obj/machinery/body_scanconsole{dir = 8},/obj/effect/floor_decal/corner/paleblue/diagonal{tag = "icon-corner_white_diagonal (EAST)"; icon_state = "corner_white_diagonal"; dir = 4},/turf/simulated/floor/tiled/white,/area/space)
"f" = (/obj/machinery/light{dir = 1},/obj/effect/floor_decal/corner/paleblue/diagonal{tag = "icon-corner_white_diagonal (EAST)"; icon_state = "corner_white_diagonal"; dir = 4},/turf/simulated/floor/tiled/white,/area/space)
"g" = (/obj/machinery/firealarm{pixel_y = 28},/obj/effect/floor_decal/corner/paleblue/diagonal{tag = "icon-corner_white_diagonal (EAST)"; icon_state = "corner_white_diagonal"; dir = 4},/turf/simulated/floor/tiled/white,/area/space)
"h" = (/obj/item/weapon/cigbutt,/turf/simulated/floor/carpet,/area/space)
"i" = (/turf/simulated/floor/carpet,/area/space)
"j" = (/obj/structure/table/standard,/obj/item/weapon/storage/firstaid/fire{pixel_x = 3; pixel_y = 3},/obj/item/weapon/storage/firstaid/fire{pixel_x = 0; pixel_y = 0},/obj/effect/floor_decal/corner/paleblue/diagonal{tag = "icon-corner_white_diagonal (EAST)"; icon_state = "corner_white_diagonal"; dir = 4},/turf/simulated/floor/tiled/white,/area/space)
"k" = (/obj/structure/table/standard,/obj/item/weapon/storage/firstaid/regular{pixel_x = 2; pixel_y = 6},/obj/item/weapon/storage/firstaid/regular{pixel_x = -2; pixel_y = 4},/obj/item/weapon/storage/firstaid/adv{pixel_x = 2; pixel_y = 2},/obj/item/weapon/storage/firstaid/adv{pixel_x = -2},/obj/effect/floor_decal/corner/paleblue/diagonal{tag = "icon-corner_white_diagonal (EAST)"; icon_state = "corner_white_diagonal"; dir = 4},/turf/simulated/floor/tiled/white,/area/space)
"l" = (/obj/effect/floor_decal/corner/paleblue/diagonal{tag = "icon-corner_white_diagonal (EAST)"; icon_state = "corner_white_diagonal"; dir = 4},/turf/simulated/floor/tiled/white,/area/space)
"m" = (/obj/machinery/dna_scannernew,/obj/effect/floor_decal/corner/paleblue/diagonal{tag = "icon-corner_white_diagonal (EAST)"; icon_state = "corner_white_diagonal"; dir = 4},/turf/simulated/floor/tiled/white,/area/space)
"n" = (/obj/effect/floor_decal/corner/paleblue/diagonal{tag = "icon-corner_white_diagonal (EAST)"; icon_state = "corner_white_diagonal"; dir = 4},/obj/item/weapon/cigbutt,/turf/simulated/floor/tiled/white,/area/space)
"o" = (/obj/machinery/computer/cloning,/obj/machinery/light{icon_state = "tube1"; dir = 4},/obj/effect/floor_decal/corner/paleblue/diagonal{tag = "icon-corner_white_diagonal (EAST)"; icon_state = "corner_white_diagonal"; dir = 4},/turf/simulated/floor/tiled/white,/area/space)
"p" = (/obj/machinery/disposal,/obj/structure/disposalpipe/trunk,/obj/machinery/computer/security/telescreen/entertainment{pixel_x = -32},/obj/effect/floor_decal/corner/paleblue/diagonal{tag = "icon-corner_white_diagonal (EAST)"; icon_state = "corner_white_diagonal"; dir = 4},/turf/simulated/floor/tiled/white,/area/space)
"q" = (/obj/machinery/hologram/holopad,/turf/simulated/floor/carpet,/area/space)
"r" = (/obj/item/stack/medical/bruise_pack,/obj/effect/floor_decal/corner/paleblue/diagonal{tag = "icon-corner_white_diagonal (EAST)"; icon_state = "corner_white_diagonal"; dir = 4},/turf/simulated/floor/tiled/white,/area/space)
"s" = (/obj/machinery/clonepod,/obj/effect/floor_decal/corner/paleblue/diagonal{tag = "icon-corner_white_diagonal (EAST)"; icon_state = "corner_white_diagonal"; dir = 4},/turf/simulated/floor/tiled/white,/area/space)
"t" = (/obj/structure/disposalpipe/segment,/obj/effect/floor_decal/corner/paleblue/diagonal{tag = "icon-corner_white_diagonal (EAST)"; icon_state = "corner_white_diagonal"; dir = 4},/obj/machinery/shieldgen,/turf/simulated/floor/tiled/white,/area/space)
"u" = (/obj/item/stack/medical/ointment,/obj/effect/floor_decal/corner/paleblue/diagonal{tag = "icon-corner_white_diagonal (EAST)"; icon_state = "corner_white_diagonal"; dir = 4},/turf/simulated/floor/tiled/white,/area/space)
"v" = (/obj/machinery/sleeper{tag = "icon-sleeper_0 (WEST)"; icon_state = "sleeper_0"; dir = 8},/obj/effect/floor_decal/corner/paleblue/diagonal{tag = "icon-corner_white_diagonal (EAST)"; icon_state = "corner_white_diagonal"; dir = 4},/turf/simulated/floor/tiled/white,/area/space)
"w" = (/obj/structure/disposalpipe/segment,/obj/effect/floor_decal/corner/paleblue/diagonal{tag = "icon-corner_white_diagonal (EAST)"; icon_state = "corner_white_diagonal"; dir = 4},/obj/structure/table/standard,/obj/machinery/recharger,/turf/simulated/floor/tiled/white,/area/space)
"x" = (/obj/structure/table/standard,/obj/item/weapon/storage/firstaid/o2{pixel_x = 3; pixel_y = 3},/obj/item/weapon/storage/firstaid/o2,/obj/effect/floor_decal/corner/paleblue/diagonal{tag = "icon-corner_white_diagonal (EAST)"; icon_state = "corner_white_diagonal"; dir = 4},/turf/simulated/floor/tiled/white,/area/space)
"y" = (/obj/structure/table/standard,/obj/item/weapon/reagent_containers/blood/AMinus{pixel_x = -7; pixel_y = -3},/obj/item/weapon/reagent_containers/blood/APlus{pixel_x = -5; pixel_y = 4},/obj/item/weapon/reagent_containers/blood/empty{pixel_x = 1; pixel_y = -4},/obj/item/weapon/reagent_containers/blood/empty{pixel_x = 1; pixel_y = -4},/obj/item/weapon/reagent_containers/blood/BMinus{pixel_y = 4},/obj/item/weapon/reagent_containers/blood/BPlus{pixel_x = 5; pixel_y = 3},/obj/item/weapon/reagent_containers/blood/OMinus{pixel_x = -5; pixel_y = -1},/obj/item/weapon/reagent_containers/blood/OPlus{pixel_x = 4; pixel_y = 2},/obj/effect/floor_decal/corner/paleblue/diagonal{tag = "icon-corner_white_diagonal (EAST)"; icon_state = "corner_white_diagonal"; dir = 4},/turf/simulated/floor/tiled/white,/area/space)
"z" = (/obj/machinery/iv_drip,/obj/effect/floor_decal/corner/paleblue/diagonal{tag = "icon-corner_white_diagonal (EAST)"; icon_state = "corner_white_diagonal"; dir = 4},/turf/simulated/floor/tiled/white,/area/space)
"A" = (/obj/structure/reagent_dispensers/water_cooler,/obj/effect/floor_decal/corner/paleblue/diagonal{tag = "icon-corner_white_diagonal (EAST)"; icon_state = "corner_white_diagonal"; dir = 4},/turf/simulated/floor/tiled/white,/area/space)
"B" = (/obj/structure/grille,/obj/structure/window/reinforced,/obj/structure/window/reinforced{dir = 1},/obj/structure/window/reinforced{dir = 8},/obj/structure/disposalpipe/segment,/turf/simulated/floor/plating,/area/space)
"C" = (/obj/structure/grille,/obj/structure/window/reinforced,/obj/structure/window/reinforced{dir = 1},/turf/simulated/floor/plating,/area/space)
"D" = (/obj/structure/grille,/obj/structure/window/reinforced,/obj/structure/window/reinforced{dir = 1},/obj/structure/window/reinforced{dir = 4},/turf/simulated/floor/plating,/area/space)
"E" = (/obj/machinery/door/firedoor,/obj/machinery/door/airlock/glass{name = "Lounge"},/turf/simulated/floor/carpet,/area/space)
"F" = (/obj/structure/table/standard/flipped/s,/turf/simulated/floor/carpet,/area/space)
"G" = (/obj/structure/grille,/obj/structure/window/reinforced,/obj/structure/window/reinforced{dir = 1},/obj/structure/window/reinforced{dir = 8},/turf/simulated/floor/plating,/area/space)

(1,1,1) = {"
aaaabcaaaaaa
defghijkllma
lllniillnloa
aplliqlrllsa
atluiillllva
awlliixyzlAa
aBCDEFGCCCDa
"}
