"a" = (/obj/structure/extinguisher_cabinet{pixel_x = -5; pixel_y = 30},/obj/effect/floor_decal/corner/beige{tag = "icon-corner_white (NORTH)"; icon_state = "corner_white"; dir = 1},/turf/simulated/floor/tiled,/area/outpost/mining_main/hallway)
"b" = (/obj/machinery/light{dir = 1},/obj/effect/floor_decal/corner/beige{tag = "icon-corner_white (NORTH)"; icon_state = "corner_white"; dir = 1},/turf/simulated/floor/tiled,/area/outpost/mining_main/hallway)
"c" = (/obj/effect/floor_decal/corner/beige{tag = "icon-corner_white (NORTH)"; icon_state = "corner_white"; dir = 1},/turf/simulated/floor/tiled,/area/outpost/mining_main/hallway)
"d" = (/obj/effect/floor_decal/corner/beige{tag = "icon-corner_white (NORTH)"; icon_state = "corner_white"; dir = 1},/obj/structure/table/standard/flipped/e,/turf/simulated/floor/tiled,/area/outpost/mining_main/hallway)
"e" = (/turf/simulated/floor/tiled,/area/outpost/mining_main/hallway)
"f" = (/obj/structure/table/standard/flipped/e,/turf/simulated/floor/tiled,/area/outpost/mining_main/hallway)
"g" = (/obj/item/stack/rods{amount = 50},/turf/simulated/floor/tiled,/area/outpost/mining_main/hallway)
"h" = (/obj/effect/floor_decal/corner/red{tag = "icon-corner_white (SOUTHWEST)"; icon_state = "corner_white"; dir = 10},/turf/simulated/floor/tiled,/area/outpost/mining_main/hallway)
"i" = (/obj/effect/floor_decal/corner/red{tag = "icon-corner_white (WEST)"; icon_state = "corner_white"; dir = 8},/obj/structure/table/standard/flipped/e,/turf/simulated/floor/tiled,/area/outpost/mining_main/hallway)
"j" = (/obj/effect/floor_decal/corner/beige{tag = "icon-corner_white (WEST)"; icon_state = "corner_white"; dir = 8},/turf/simulated/floor/tiled,/area/outpost/mining_main/hallway)
"k" = (/obj/effect/floor_decal/corner/beige{tag = "icon-corner_white (WEST)"; icon_state = "corner_white"; dir = 8},/obj/machinery/camera/network/mining{c_tag = "Outpost Hallway 2"; dir = 1; icon_state = "camera"},/turf/simulated/floor/tiled,/area/outpost/mining_main/hallway)
"l" = (/obj/machinery/light,/obj/effect/floor_decal/corner/beige{tag = "icon-corner_white (WEST)"; icon_state = "corner_white"; dir = 8},/turf/simulated/floor/tiled,/area/outpost/mining_main/hallway)

(1,1,1) = {"
abccdc
efegfe
hijjkl
"}
