"a" = (/obj/machinery/atmospherics/pipe/simple/hidden/supply,/obj/item/weapon/cigbutt,/turf/simulated/floor/tiled/steel,/area/template_noop)
"b" = (/turf/simulated/wall,/area/template_noop)
"c" = (/obj/machinery/light{dir = 8},/turf/simulated/floor/tiled/steel,/area/template_noop)
"d" = (/obj/machinery/firealarm{dir = 4; pixel_x = 24},/obj/item/ammo_casing/c9mm,/turf/simulated/floor/tiled/steel,/area/template_noop)
"e" = (/obj/machinery/atmospherics/pipe/simple/hidden/supply,/obj/structure/table/standard/flipped/n,/turf/simulated/floor/tiled/steel,/area/template_noop)
"f" = (/obj/item/device/radio/intercom{frequency = 1459; name = "Station Intercom (General)"; pixel_x = -30},/obj/item/ammo_casing/c9mm,/turf/simulated/floor/tiled/steel,/area/template_noop)
"g" = (/turf/simulated/floor/tiled/steel,/area/template_noop)
"h" = (/obj/machinery/atmospherics/pipe/simple/hidden/supply,/obj/item/ammo_magazine/c38,/turf/simulated/floor/tiled/steel,/area/template_noop)
"i" = (/obj/structure/girder,/turf/simulated/floor/plating,/area/template_noop)
"j" = (/obj/item/weapon/cigbutt,/turf/simulated/floor/tiled/steel,/area/template_noop)
"k" = (/obj/structure/extinguisher_cabinet{pixel_x = 32},/turf/simulated/floor/tiled/steel,/area/template_noop)
"l" = (/obj/machinery/atmospherics/pipe/simple/hidden/supply,/turf/simulated/floor/tiled/steel,/area/template_noop)
"m" = (/obj/machinery/newscaster{pixel_x = 32},/obj/item/ammo_casing/c9mm,/obj/item/weapon/cigbutt,/turf/simulated/floor/tiled/steel,/area/template_noop)
"n" = (/obj/machinery/atmospherics/pipe/simple/hidden/supply,/obj/structure/table/standard,/obj/item/weapon/storage/firstaid/adv,/turf/simulated/floor/tiled/steel,/area/template_noop)
"o" = (/obj/structure/table/standard/flipped/n,/turf/simulated/floor/tiled/steel,/area/template_noop)
"p" = (/obj/machinery/atm{pixel_x = 30},/obj/structure/table/standard/flipped/n,/turf/simulated/floor/tiled/steel,/area/space)
"q" = (/obj/machinery/dna_scannernew,/obj/machinery/atmospherics/pipe/simple/hidden/supply,/turf/simulated/floor/tiled/steel,/area/template_noop)
"r" = (/obj/item/device/flashlight/lamp/green,/turf/simulated/floor/tiled/steel,/area/template_noop)
"s" = (/obj/item/ammo_casing/c9mm,/turf/simulated/floor/tiled/steel,/area/template_noop)
"t" = (/obj/item/ammo_magazine/c45m/a7/empty,/turf/simulated/floor/tiled/steel,/area/template_noop)
"u" = (/obj/machinery/computer/cloning,/obj/machinery/atmospherics/pipe/simple/hidden/supply,/turf/simulated/floor/tiled/steel,/area/template_noop)
"v" = (/obj/machinery/clonepod,/obj/machinery/atmospherics/pipe/simple/hidden/supply{dir = 5},/turf/simulated/floor/tiled/steel,/area/template_noop)
"w" = (/obj/machinery/atmospherics/pipe/simple/hidden/supply{color = "#4444FF"; dir = 4},/turf/simulated/floor/tiled/steel,/area/template_noop)
"x" = (/obj/machinery/atmospherics/pipe/simple/hidden/supply{dir = 10},/turf/simulated/floor/tiled/steel,/area/template_noop)
"y" = (/obj/machinery/light{dir = 4},/turf/simulated/floor/tiled/steel,/area/template_noop)

(1,1,1) = {"
abcdb
ebfgb
hijkb
lggmb
njopb
qrstb
ugsgb
vwxyb
"}
