"a" = (/obj/machinery/door/firedoor,/obj/machinery/door/airlock/glass{name = "Central Access"},/turf/simulated/floor/tiled/steel,/area/template_noop)
"b" = (/turf/simulated/wall,/area/template_noop)
"c" = (/turf/simulated/floor/plating,/area/template_noop)
"d" = (/obj/machinery/space_heater,/turf/simulated/floor/plating,/area/template_noop)
"e" = (/obj/structure/table/rack{dir = 1},/obj/item/device/flashlight,/obj/machinery/light/small/red{tag = "icon-firelight1 (NORTH)"; icon_state = "firelight1"; dir = 1},/turf/simulated/floor/plating,/area/template_noop)
"f" = (/obj/structure/disposalpipe/segment{dir = 4},/turf/simulated/floor/tiled/steel,/area/template_noop)
"g" = (/obj/machinery/door/airlock/maintenance{req_access = list(12)},/obj/structure/disposalpipe/segment{dir = 4},/turf/simulated/floor/plating,/area/template_noop)
"h" = (/obj/structure/disposalpipe/segment{dir = 4},/turf/simulated/floor/plating,/area/template_noop)
"i" = (/turf/simulated/floor/tiled/steel,/area/template_noop)
"j" = (/obj/structure/extinguisher_cabinet{pixel_x = 32},/turf/simulated/floor/tiled/steel,/area/template_noop)
"k" = (/turf/simulated/wall/r_wall,/area/template_noop)
"l" = (/obj/machinery/light{dir = 4},/turf/simulated/floor/tiled/steel,/area/template_noop)
"m" = (/obj/machinery/suit_storage_unit/anfor,/turf/simulated/floor/tiled/dark,/area/template_noop)
"n" = (/obj/machinery/vending/urist/assaultammodispenser,/turf/simulated/floor/tiled/dark,/area/template_noop)
"o" = (/obj/machinery/newscaster{pixel_x = -32},/obj/structure/table/standard/flipped/n,/turf/simulated/floor/tiled/steel,/area/template_noop)
"p" = (/obj/structure/table/standard/flipped/n,/turf/simulated/floor/tiled/steel,/area/template_noop)
"q" = (/obj/machinery/camera{c_tag = "Arrivals Hallway South"; dir = 8; network = list("Exodus")},/obj/structure/table/standard/flipped/n,/turf/simulated/floor/tiled/steel,/area/template_noop)
"r" = (/obj/machinery/light{icon_state = "tube1"; dir = 8},/obj/machinery/light_switch{pixel_x = -28; pixel_y = 0},/turf/simulated/floor/tiled/dark,/area/template_noop)
"s" = (/turf/simulated/floor/tiled/dark,/area/template_noop)
"t" = (/obj/item/stack/tile/floor_steel,/turf/simulated/floor/tiled/steel,/area/template_noop)
"u" = (/obj/machinery/door/airlock/engineering{name = "Marine Dorms"; req_access = list(101)},/turf/simulated/floor/tiled/dark,/area/template_noop)
"v" = (/obj/effect/landmark/assault/marinespawn,/obj/structure/bed/nice,/obj/item/weapon/bedsheet/white,/turf/simulated/floor/tiled/dark,/area/template_noop)
"w" = (/obj/effect/landmark/assault/marinespawn,/obj/structure/bed/nice,/obj/item/weapon/bedsheet/white,/obj/machinery/light{dir = 4},/turf/simulated/floor/tiled/dark,/area/template_noop)
"x" = (/obj/structure/grille,/obj/structure/window/phoronreinforced,/obj/structure/window/phoronreinforced{tag = "icon-phoronrwindow (NORTH)"; icon_state = "phoronrwindow"; dir = 1},/obj/structure/window/phoronreinforced{tag = "icon-phoronrwindow (WEST)"; icon_state = "phoronrwindow"; dir = 8},/obj/structure/window/phoronreinforced{tag = "icon-phoronrwindow (EAST)"; icon_state = "phoronrwindow"; dir = 4},/turf/simulated/floor/plating,/area/template_noop)
"y" = (/obj/item/stack/rods,/turf/simulated/floor/tiled/steel,/area/template_noop)
"z" = (/obj/item/device/radio/intercom{name = "Station Intercom (General)"; pixel_y = -29},/obj/structure/closet/crate{icon_state = "crateopen"; opened = 1},/obj/item/weapon/gun/projectile/a18/gl,/obj/item/weapon/gun/projectile/a18/gl,/obj/item/weapon/gun/projectile/a18/gl,/obj/item/weapon/gun/projectile/a18/gl,/obj/item/weapon/gun/projectile/a18/gl,/obj/item/weapon/gun/projectile/a18/scoped,/obj/item/weapon/gun/projectile/a18/scoped,/obj/item/weapon/gun/projectile/a18/scoped,/obj/item/weapon/gun/projectile/a18/scoped,/obj/item/weapon/gun/projectile/a18/scoped,/turf/simulated/floor/tiled/dark,/area/template_noop)
"A" = (/obj/structure/closet/crate{icon_state = "crateopen"; opened = 1},/obj/item/ammo_magazine/a762mm/a18,/obj/item/ammo_magazine/a762mm/a18,/obj/item/ammo_magazine/a762mm/a18,/obj/item/ammo_magazine/a762mm/a18,/obj/item/ammo_magazine/a762mm/a18,/obj/item/ammo_magazine/a762mm/a18,/obj/item/ammo_magazine/a762mm/a18,/obj/item/ammo_magazine/a762mm/a18,/obj/item/ammo_magazine/a762mm/a18,/obj/item/ammo_magazine/a762mm/a18,/obj/item/ammo_magazine/a762mm/a18,/obj/item/ammo_magazine/a762mm/a18,/obj/item/ammo_magazine/a762mm/a18,/obj/item/ammo_magazine/a762mm/a18,/obj/item/ammo_magazine/a762mm/a18,/obj/item/ammo_magazine/a762mm/a18,/obj/item/ammo_magazine/a762mm/a18,/obj/item/ammo_magazine/a762mm/a18,/obj/item/ammo_magazine/a762mm/a18,/obj/item/ammo_magazine/a762mm/a18,/turf/simulated/floor/tiled/dark,/area/template_noop)
"B" = (/obj/structure/closet/crate{icon_state = "crateopen"; opened = 1},/obj/item/weapon/storage/box/anforgrenade,/obj/item/weapon/storage/box/anforgrenade,/obj/item/weapon/storage/box/anforgrenade,/obj/item/weapon/storage/box/anforgrenade,/obj/item/weapon/storage/box/mines,/obj/item/weapon/storage/box/mines,/turf/simulated/floor/tiled/dark,/area/template_noop)
"C" = (/obj/structure/closet/crate{icon_state = "crateopen"; opened = 1},/obj/item/weapon/gun/projectile/automatic/asmg,/obj/item/weapon/gun/projectile/automatic/asmg,/obj/item/weapon/gun/projectile/automatic/asmg,/obj/item/weapon/gun/projectile/automatic/asmg,/obj/item/weapon/gun/projectile/automatic/asmg,/obj/item/ammo_magazine/a9mm,/obj/item/ammo_magazine/a9mm,/obj/item/ammo_magazine/a9mm,/obj/item/ammo_magazine/a9mm,/obj/item/ammo_magazine/a9mm,/obj/item/ammo_magazine/a9mm,/obj/item/ammo_magazine/a9mm,/obj/item/ammo_magazine/a9mm,/obj/item/ammo_magazine/a9mm,/obj/item/ammo_magazine/a9mm,/obj/item/ammo_magazine/a9mm,/obj/item/ammo_magazine/a9mm,/obj/item/ammo_magazine/a9mm,/obj/item/ammo_magazine/a9mm,/obj/item/ammo_magazine/a9mm,/obj/item/ammo_magazine/a9mm,/obj/item/ammo_magazine/a9mm,/obj/item/ammo_magazine/a9mm,/obj/item/ammo_magazine/a9mm,/obj/item/ammo_magazine/a9mm,/turf/simulated/floor/tiled/dark,/area/template_noop)
"D" = (/obj/structure/closet/crate{icon_state = "crateopen"; opened = 1},/obj/item/weapon/gun/projectile/colt/a7,/obj/item/weapon/gun/projectile/colt/a7,/obj/item/weapon/gun/projectile/colt/a7,/obj/item/weapon/gun/projectile/colt/a7,/obj/item/weapon/gun/projectile/colt/a7,/obj/item/ammo_magazine/c45m/a7,/obj/item/ammo_magazine/c45m/a7,/obj/item/ammo_magazine/c45m/a7,/obj/item/ammo_magazine/c45m/a7,/obj/item/ammo_magazine/c45m/a7,/obj/item/ammo_magazine/c45m/a7,/obj/item/ammo_magazine/c45m/a7,/obj/item/ammo_magazine/c45m/a7,/obj/item/ammo_magazine/c45m/a7,/obj/item/ammo_magazine/c45m/a7,/turf/simulated/floor/tiled/dark,/area/template_noop)
"E" = (/obj/structure/closet/crate{icon_state = "crateopen"; opened = 1},/obj/item/weapon/gun/projectile/automatic/a22,/obj/item/weapon/gun/projectile/automatic/a22,/obj/item/weapon/gun/projectile/automatic/a22,/obj/item/weapon/gun/projectile/automatic/a22,/obj/item/weapon/gun/projectile/automatic/a22,/obj/item/ammo_magazine/a556/a22,/obj/item/ammo_magazine/a556/a22,/obj/item/ammo_magazine/a556/a22,/obj/item/ammo_magazine/a556/a22,/obj/item/ammo_magazine/a556/a22,/obj/item/ammo_magazine/a556/a22,/obj/item/ammo_magazine/a556/a22,/obj/item/ammo_magazine/a556/a22,/obj/item/ammo_magazine/a556/a22,/obj/item/ammo_magazine/a556/a22,/obj/item/ammo_magazine/a556/a22,/obj/item/ammo_magazine/a556/a22,/obj/item/ammo_magazine/a556/a22,/obj/item/ammo_magazine/a556/a22,/obj/item/ammo_magazine/a556/a22,/obj/item/ammo_magazine/a556/a22,/obj/item/ammo_magazine/a556/a22,/obj/item/ammo_magazine/a556/a22,/obj/item/ammo_magazine/a556/a22,/obj/item/ammo_magazine/a556/a22,/turf/simulated/floor/tiled/dark,/area/template_noop)
"F" = (/obj/machinery/door/airlock/glass{name = "Central Access"},/turf/simulated/floor/tiled/steel,/area/template_noop)
"G" = (/obj/structure/grille,/obj/structure/window/phoronreinforced,/obj/structure/window/phoronreinforced{tag = "icon-phoronrwindow (NORTH)"; icon_state = "phoronrwindow"; dir = 1},/obj/structure/window/phoronreinforced{tag = "icon-phoronrwindow (WEST)"; icon_state = "phoronrwindow"; dir = 8},/turf/simulated/floor/plating,/area/template_noop)
"H" = (/obj/structure/grille,/obj/structure/window/phoronreinforced,/obj/structure/window/phoronreinforced{tag = "icon-phoronrwindow (NORTH)"; icon_state = "phoronrwindow"; dir = 1},/turf/simulated/floor/plating,/area/template_noop)
"I" = (/obj/structure/grille,/obj/structure/window/phoronreinforced,/obj/structure/window/phoronreinforced{tag = "icon-phoronrwindow (EAST)"; icon_state = "phoronrwindow"; dir = 4},/obj/structure/window/phoronreinforced{tag = "icon-phoronrwindow (NORTH)"; icon_state = "phoronrwindow"; dir = 1},/turf/simulated/floor/plating,/area/template_noop)

(1,1,1) = {"
aaabbbccbde
fffghhhhhhh
iijkkkkkkkk
iilkmmmmnnk
opqkrsssssk
tiiussvvvwk
iiixssssssk
yitkzABCDEk
FaFkkkGHIkk
"}
