"a" = (/turf/simulated/wall/r_wall,/area/outpost/mining_main/dorms)
"b" = (/turf/simulated/wall/r_wall,/area/space)
"c" = (/obj/structure/table/standard,/obj/machinery/light{brightness_power = 4; brightness_range = 9; dir = 8; icon_state = "tube1"},/obj/item/weapon/reagent_containers/food/condiment/peppermill{pixel_x = 3},/obj/item/weapon/reagent_containers/food/condiment/saltshaker{pixel_x = -3; pixel_y = 0},/turf/simulated/floor/tiled/white,/area/outpost/mining_main/dorms)
"d" = (/obj/machinery/suit_storage_unit/anfor,/turf/simulated/floor/tiled/dark,/area/outpost/mining_main/dorms)
"e" = (/obj/machinery/vending/urist/assaultammodispenser,/turf/simulated/floor/tiled/dark,/area/outpost/mining_main/dorms)
"f" = (/obj/structure/closet/crate{icon_state = "crateopen"; opened = 1},/obj/item/weapon/gun/projectile/automatic/a22,/obj/item/weapon/gun/projectile/automatic/a22,/obj/item/weapon/gun/projectile/automatic/a22,/obj/item/weapon/gun/projectile/automatic/a22,/obj/item/weapon/gun/projectile/automatic/a22,/obj/item/ammo_magazine/a556/a22,/obj/item/ammo_magazine/a556/a22,/obj/item/ammo_magazine/a556/a22,/obj/item/ammo_magazine/a556/a22,/obj/item/ammo_magazine/a556/a22,/obj/item/ammo_magazine/a556/a22,/obj/item/ammo_magazine/a556/a22,/obj/item/ammo_magazine/a556/a22,/obj/item/ammo_magazine/a556/a22,/obj/item/ammo_magazine/a556/a22,/obj/item/ammo_magazine/a556/a22,/obj/item/ammo_magazine/a556/a22,/obj/item/ammo_magazine/a556/a22,/obj/item/ammo_magazine/a556/a22,/obj/item/ammo_magazine/a556/a22,/obj/item/ammo_magazine/a556/a22,/obj/item/ammo_magazine/a556/a22,/obj/item/ammo_magazine/a556/a22,/obj/item/ammo_magazine/a556/a22,/obj/item/ammo_magazine/a556/a22,/turf/simulated/floor/tiled/dark,/area/outpost/mining_main/dorms)
"g" = (/obj/machinery/light{dir = 1},/obj/structure/table/rack,/obj/item/weapon/gun/projectile/revolver,/obj/item/weapon/gun/projectile/colt,/obj/item/weapon/gun/energy/laser,/obj/item/weapon/gun/energy/laser,/obj/item/weapon/gun/energy/laser,/turf/simulated/floor/tiled/dark,/area/outpost/mining_main/dorms)
"h" = (/obj/structure/table/standard,/obj/machinery/microwave{pixel_y = 6},/turf/simulated/floor/tiled/white,/area/outpost/mining_main/dorms)
"i" = (/obj/machinery/light{brightness_power = 5; brightness_range = 10; dir = 8},/turf/simulated/floor/tiled,/area/outpost/mining_main/dorms)
"j" = (/turf/simulated/floor/tiled,/area/outpost/mining_main/dorms)
"k" = (/obj/machinery/door/airlock/security,/turf/simulated/floor/tiled/white,/area/outpost/mining_main/dorms)
"l" = (/turf/simulated/floor/tiled/white,/area/outpost/mining_main/dorms)
"m" = (/obj/item/stack/material/steel{amount = 50},/turf/simulated/floor/tiled,/area/outpost/mining_main/dorms)
"n" = (/obj/structure/table/standard,/obj/item/weapon/storage/box/donkpockets,/turf/simulated/floor/tiled/white,/area/outpost/mining_main/dorms)
"o" = (/obj/structure/assaultshieldgen,/obj/structure/window/phoronreinforced{tag = "icon-phoronrwindow (NORTH)"; icon_state = "phoronrwindow"; dir = 1},/turf/simulated/floor/tiled,/area/outpost/mining_main/dorms)
"p" = (/obj/structure/assaultshieldgen,/obj/structure/window/phoronreinforced{tag = "icon-phoronrwindow (EAST)"; icon_state = "phoronrwindow"; dir = 4},/obj/structure/window/phoronreinforced{tag = "icon-phoronrwindow (NORTH)"; icon_state = "phoronrwindow"; dir = 1},/turf/simulated/floor/tiled,/area/outpost/mining_main/dorms)
"q" = (/obj/structure/assaultshieldgen,/obj/structure/window/phoronreinforced,/turf/simulated/floor/tiled,/area/outpost/mining_main/dorms)
"r" = (/obj/structure/assaultshieldgen,/obj/structure/window/phoronreinforced,/obj/structure/window/phoronreinforced{tag = "icon-phoronrwindow (EAST)"; icon_state = "phoronrwindow"; dir = 4},/turf/simulated/floor/tiled,/area/outpost/mining_main/dorms)
"s" = (/obj/item/stack/rods{amount = 50},/turf/simulated/floor/tiled,/area/outpost/mining_main/dorms)
"t" = (/obj/structure/table/standard,/obj/item/stack/material/steel{amount = 50},/obj/item/stack/material/steel{amount = 50},/obj/item/stack/material/plasteel{amount = 10},/obj/item/stack/material/plasteel{amount = 10},/obj/item/stack/rods{amount = 50},/turf/simulated/floor/tiled,/area/outpost/mining_main/dorms)
"u" = (/obj/machinery/light{dir = 4},/obj/structure/table/standard,/obj/item/stack/material/glass{amount = 50},/obj/item/stack/material/glass/reinforced{amount = 50},/turf/simulated/floor/tiled,/area/outpost/mining_main/dorms)
"v" = (/obj/structure/table/standard/flipped/s,/turf/simulated/floor/tiled,/area/outpost/mining_main/dorms)

(1,1,1) = {"
aabbbbaac
addeefgah
aijjjjjkl
ajjjmjjan
aopjjjjaa
aqrjsjjta
ajjjjjjua
aijjjjjva
"}
