"a" = (/obj/structure/grille,/obj/structure/window/reinforced{dir = 1},/obj/structure/window/reinforced,/turf/simulated/floor/plating/airless,/area/maintenance/atmos_control)
"b" = (/obj/structure/grille,/obj/structure/window/reinforced{dir = 4},/obj/structure/window/reinforced{dir = 1},/turf/simulated/floor/plating,/area/maintenance/atmos_control)
"c" = (/obj/machinery/door/airlock/external,/turf/simulated/floor/plating,/area/maintenance/atmos_control)
"d" = (/obj/structure/grille,/obj/structure/window/reinforced{dir = 8},/obj/structure/window/reinforced{dir = 1},/turf/simulated/floor/plating,/area/maintenance/atmos_control)
"e" = (/turf/space,/area/space)
"f" = (/obj/structure/grille,/obj/structure/window/reinforced{dir = 4},/obj/structure/window/reinforced{dir = 8},/turf/simulated/wall,/area/maintenance/atmos_control)
"g" = (/turf/simulated/floor/plating,/area/maintenance/atmos_control)
"h" = (/obj/structure/grille,/obj/structure/window/reinforced{dir = 4},/obj/structure/window/reinforced{dir = 8},/obj/structure/window/reinforced,/turf/simulated/wall,/area/maintenance/atmos_control)
"i" = (/turf/space,/area/shuttle/assault/a2/station)

(1,1,1) = {"
aaabccdaa
eeefggfee
eeehcchee
eeiiiiiee
eeiiiiiee
iiiiiiiii
iiiiiiiii
iiiiiiiii
iiiiiiiii
iiiiiiiii
iiiiiiiii
iiiiiiiii
iiiiiiiii
iiiiiiiii
iiiiiiiii
iiiiiiiii
iiiiiiiii
iiiiiiiii
iiiiiiiii
"}
