"a" = (/turf/simulated/wall,/area/hallway/primary/central_one)
"b" = (/obj/structure/closet/wardrobe/tactical,/obj/item/weapon/gun/projectile/shotgun/doublebarrel,/turf/simulated/floor/reinforced,/area/hallway/primary/central_one)
"c" = (/obj/machinery/camera{c_tag = "Central Primary Hallway Garden North"},/obj/structure/sign/atmosplaque{desc = "A plaque commemorating the fallen, may they rest in peace, forever asleep amongst the stars. Someone has drawn a picture of a crying badger at the bottom. "; icon_state = "kiddieplaque"; name = "Remembrance Plaque"; pixel_x = 0; pixel_y = 32},/turf/simulated/floor/reinforced,/area/hallway/primary/central_one)
"d" = (/turf/simulated/floor/reinforced,/area/hallway/primary/central_one)
"e" = (/obj/item/weapon/storage/firstaid/regular,/turf/simulated/floor/reinforced,/area/hallway/primary/central_one)
"f" = (/obj/structure/sign/atmosplaque{pixel_y = 32},/turf/simulated/floor/reinforced,/area/hallway/primary/central_one)
"g" = (/obj/structure/closet/wardrobe/tactical,/turf/simulated/floor/reinforced,/area/hallway/primary/central_one)
"h" = (/obj/machinery/sleeper,/turf/simulated/floor/reinforced,/area/hallway/primary/central_one)
"i" = (/obj/structure/table/standard/flipped/n,/turf/simulated/floor/reinforced,/area/hallway/primary/central_one)
"j" = (/obj/item/stack/medical/ointment,/turf/simulated/floor/reinforced,/area/hallway/primary/central_one)
"k" = (/obj/item/trash/cigbutt,/turf/simulated/floor/reinforced,/area/hallway/primary/central_one)
"l" = (/obj/structure/table/standard/flipped/w,/turf/simulated/floor/reinforced,/area/hallway/primary/central_one)
"m" = (/obj/structure/table/standard/flipped/e,/turf/simulated/floor/reinforced,/area/hallway/primary/central_one)
"n" = (/obj/item/weapon/storage/firstaid/combat,/obj/item/weapon/storage/firstaid/combat,/turf/simulated/floor/reinforced,/area/hallway/primary/central_one)
"o" = (/obj/structure/window/phoronreinforced{tag = "icon-phoronrwindow (WEST)"; icon_state = "phoronrwindow"; dir = 8},/obj/structure/window/phoronreinforced{tag = "icon-phoronrwindow (NORTH)"; icon_state = "phoronrwindow"; dir = 1},/obj/structure/assaultshieldgen,/turf/simulated/floor/reinforced,/area/hallway/primary/central_one)
"p" = (/obj/structure/window/phoronreinforced{tag = "icon-phoronrwindow (EAST)"; icon_state = "phoronrwindow"; dir = 4},/obj/structure/window/phoronreinforced{tag = "icon-phoronrwindow (NORTH)"; icon_state = "phoronrwindow"; dir = 1},/obj/structure/assaultshieldgen,/turf/simulated/floor/reinforced,/area/hallway/primary/central_one)
"q" = (/obj/item/stack/nanopaste,/turf/simulated/floor/reinforced,/area/hallway/primary/central_one)
"r" = (/obj/item/stack/medical/bruise_pack,/turf/simulated/floor/reinforced,/area/hallway/primary/central_one)
"s" = (/obj/item/weapon/storage/firstaid/fire,/obj/item/weapon/storage/firstaid/fire,/turf/simulated/floor/reinforced,/area/hallway/primary/central_one)
"t" = (/obj/structure/window/phoronreinforced,/obj/structure/window/phoronreinforced{tag = "icon-phoronrwindow (WEST)"; icon_state = "phoronrwindow"; dir = 8},/obj/structure/assaultshieldgen,/turf/simulated/floor/reinforced,/area/hallway/primary/central_one)
"u" = (/obj/structure/window/phoronreinforced,/obj/structure/window/phoronreinforced{tag = "icon-phoronrwindow (EAST)"; icon_state = "phoronrwindow"; dir = 4},/obj/structure/assaultshieldgen,/turf/simulated/floor/reinforced,/area/hallway/primary/central_one)
"v" = (/obj/item/weapon/storage/firstaid/adv,/obj/item/weapon/storage/firstaid/adv,/turf/simulated/floor/reinforced,/area/hallway/primary/central_one)
"w" = (/obj/item/weapon/gun/projectile/shotgun/pump,/turf/simulated/floor/reinforced,/area/hallway/primary/central_one)
"x" = (/obj/machinery/light{dir = 4},/turf/simulated/floor/reinforced,/area/hallway/primary/central_one)
"y" = (/obj/machinery/camera{c_tag = "Central Primary Hallway Garden Southwest"; dir = 4; network = list("Exodus")},/turf/simulated/floor/reinforced,/area/hallway/primary/central_one)
"z" = (/obj/item/weapon/storage/toolbox/mechanical,/turf/simulated/floor/reinforced,/area/hallway/primary/central_one)
"A" = (/obj/machinery/hologram/holopad,/turf/simulated/floor/reinforced,/area/hallway/primary/central_one)
"B" = (/obj/machinery/camera{c_tag = "Central Primary Hallway Garden South"; dir = 8; network = list("Exodus")},/obj/item/stack/medical/splint,/turf/simulated/floor/reinforced,/area/hallway/primary/central_one)
"C" = (/obj/structure/table/standard,/obj/machinery/recharger,/turf/simulated/floor/reinforced,/area/hallway/primary/central_one)
"D" = (/obj/machinery/shieldgen,/turf/simulated/floor/reinforced,/area/hallway/primary/central_one)
"E" = (/obj/structure/table/standard/flipped/s,/turf/simulated/floor/reinforced,/area/hallway/primary/central_one)
"F" = (/obj/structure/table/standard/flipped/s,/obj/item/weapon/storage/box/shotgunammo,/turf/simulated/floor/reinforced,/area/hallway/primary/central_one)
"G" = (/obj/machinery/newscaster{hitstaken = 1; pixel_x = 0; pixel_y = -32},/turf/simulated/floor/reinforced,/area/hallway/primary/central_one)
"H" = (/obj/item/device/radio/intercom{name = "Station Intercom (General)"; pixel_y = -29},/turf/simulated/floor/reinforced,/area/hallway/primary/central_one)

(1,1,1) = {"
abcddedfga
hhdiiiidhh
jdeddkdddd
dldkddddmd
dldnopqdmd
klrstuvdmd
dlwdddddmx
yddzdAdddB
CDdEFEEdDC
aCkdddGHCa
"}
