"a" = (/obj/machinery/door/firedoor,/turf/simulated/floor/tiled/steel,/area/template_noop)
"b" = (/obj/structure/cable{d1 = 1; d2 = 2; icon_state = "1-2"; pixel_y = 0},/obj/machinery/door/firedoor,/turf/simulated/floor/tiled/steel,/area/template_noop)
"c" = (/turf/simulated/wall,/area/template_noop)
"d" = (/obj/structure/cable{d1 = 1; d2 = 4; icon_state = "1-4"; tag = ""},/obj/machinery/atmospherics/pipe/simple/hidden/scrubbers,/obj/structure/disposalpipe/segment{dir = 1; icon_state = "pipe-c"},/turf/simulated/floor/plating,/area/template_noop)
"e" = (/turf/simulated/floor/tiled/steel,/area/template_noop)
"f" = (/obj/structure/cable{d1 = 1; d2 = 2; icon_state = "1-2"; pixel_y = 0},/turf/simulated/floor/tiled/steel,/area/template_noop)
"g" = (/obj/machinery/camera{c_tag = "Port Primary Hallway Central"; dir = 8; network = list("Exodus")},/turf/simulated/floor/tiled/steel,/area/template_noop)
"h" = (/obj/machinery/atmospherics/pipe/simple/hidden/scrubbers,/turf/simulated/wall,/area/template_noop)
"i" = (/obj/structure/cable{d1 = 4; d2 = 8; icon_state = "4-8"; pixel_y = 0},/obj/structure/table/standard/flipped/n,/turf/simulated/floor/tiled/steel,/area/template_noop)
"j" = (/obj/structure/cable{d1 = 1; d2 = 8; icon_state = "1-8"},/obj/structure/table/standard/flipped/n,/turf/simulated/floor/tiled/steel,/area/template_noop)
"k" = (/obj/structure/table/standard/flipped/n,/turf/simulated/floor/tiled/steel,/area/template_noop)
"l" = (/obj/machinery/atmospherics/pipe/simple/hidden/scrubbers,/obj/structure/table/standard,/obj/machinery/recharger,/turf/simulated/floor/tiled/steel,/area/template_noop)
"m" = (/obj/machinery/light{icon_state = "tube1"; dir = 8},/turf/simulated/floor/tiled/steel,/area/template_noop)
"n" = (/obj/machinery/atmospherics/pipe/simple/hidden/scrubbers,/turf/simulated/floor/tiled/steel,/area/template_noop)
"o" = (/obj/machinery/atmospherics/unary/vent_pump/on{dir = 4; layer = 2.4},/turf/simulated/floor/tiled/steel,/area/template_noop)
"p" = (/obj/machinery/atmospherics/pipe/simple/hidden/supply{dir = 4},/turf/simulated/floor/tiled/steel,/area/template_noop)
"q" = (/obj/machinery/atmospherics/pipe/simple/hidden/supply{dir = 4},/obj/machinery/atmospherics/pipe/simple/hidden/scrubbers,/obj/structure/disposalpipe/segment{dir = 4; icon_state = "pipe-c"},/turf/simulated/floor/tiled/steel,/area/template_noop)
"r" = (/obj/machinery/newscaster{pixel_x = -32},/obj/structure/table/standard/flipped/s,/turf/simulated/floor/tiled/steel,/area/template_noop)
"s" = (/obj/structure/table/standard/flipped/s,/turf/simulated/floor/tiled/steel,/area/template_noop)
"t" = (/obj/machinery/atmospherics/unary/vent_scrubber/on{dir = 4},/obj/structure/table/standard/flipped/s,/turf/simulated/floor/tiled/steel,/area/template_noop)
"u" = (/obj/machinery/atmospherics/pipe/simple/hidden/scrubbers{dir = 4},/turf/simulated/floor/tiled/steel,/area/template_noop)
"v" = (/obj/machinery/atmospherics/pipe/manifold/hidden/scrubbers{dir = 4},/obj/machinery/disposal,/obj/structure/disposalpipe/trunk{dir = 1},/turf/simulated/floor/tiled/steel,/area/template_noop)
"w" = (/obj/item/device/radio/intercom{dir = 4; name = "Station Intercom (General)"; pixel_x = 31},/turf/simulated/floor/tiled/steel,/area/template_noop)
"x" = (/obj/structure/cable{d1 = 2; d2 = 4; icon_state = "2-4"},/obj/machinery/atmospherics/pipe/simple/hidden/scrubbers,/obj/structure/disposalpipe/segment{dir = 4; icon_state = "pipe-c"},/turf/simulated/floor/plating,/area/template_noop)

(1,1,1) = {"
abacd
efgch
efeeh
ijkel
meeen
eeopq
rstuv
eeeeh
eewch
aaacx
"}
