"a" = (/obj/structure/disposalpipe/segment,/turf/simulated/floor/plating,/area/jungle)
"b" = (/turf/simulated/planet/jungle/path,/area/jungle)
"c" = (/turf/simulated/planet/jungle,/area/jungle)
"d" = (/turf/simulated/planet/jungle/path,/area/shuttle/assault/a1/station)
"e" = (/obj/structure/disposalpipe/segment,/obj/effect/floor_decal/industrial/warning{dir = 1},/turf/simulated/floor/plating,/area/jungle)
"f" = (/obj/effect/floor_decal/industrial/warning{dir = 5},/turf/simulated/floor/plating,/area/jungle)
"g" = (/obj/structure/disposalpipe/segment,/obj/effect/floor_decal/industrial/warning,/turf/simulated/floor/plating,/area/jungle)
"h" = (/obj/effect/floor_decal/industrial/warning{dir = 6},/turf/simulated/floor/plating,/area/jungle)
"i" = (/obj/structure/disposalpipe/segment{dir = 1; icon_state = "pipe-c"},/turf/simulated/floor/plating,/area/jungle)
"j" = (/obj/structure/disposalpipe/segment{dir = 4},/turf/simulated/floor/plating,/area/jungle)
"k" = (/obj/structure/disposalpipe/segment{dir = 2; icon_state = "pipe-c"},/turf/simulated/floor/plating,/area/jungle)
"l" = (/turf/simulated/planet/jungle/path,/area/shuttle/assault/a2/station)
"m" = (/obj/effect/floor_decal/industrial/warning{dir = 9},/turf/simulated/floor/plating,/area/jungle)
"n" = (/obj/effect/floor_decal/industrial/warning{dir = 10},/turf/simulated/floor/plating,/area/jungle)
"o" = (/obj/structure/disposalpipe/segment{dir = 4; icon_state = "pipe-c"},/turf/simulated/floor/plating,/area/jungle)
"p" = (/obj/structure/disposalpipe/segment{dir = 8; icon_state = "pipe-c"},/turf/simulated/floor/plating,/area/jungle)
"q" = (/turf/simulated/planet/jungle/med,/area/jungle)

(1,1,1) = {"
abbcccccccccccccccccccccccbdddddddddbbcc
efbccccccccccccccccccbcbbbbdddddddddbbcc
ghbccccccccccccccccbbbbbbbbdddddddddbbcc
accccccccccccccccccbbbbbbbbdddddddddbccc
acccccccccccccccccbbbbbbbbbdddddddddbccc
ijjkcccccccccbbbbbbbbbbbbbbdddddddddbccc
cccaccbbbbbbbbbbbbbbbbbbbbbdddddddddbbcc
cccacbbbbbbbbbbbbbbbbbbbbbbdddddddddbbcc
cccabbbbbbbbbbbccbbbbbbbbbbdddddddddbbcc
ccbabbbbbbbbbbbcccbbbbbbbbbdddddddddbccc
cbbabbbccbccccccbbbbbbbbbbbdddddddddbccc
cbbabbcccbcccccbbbbbbbbbbbbdddddddddbccc
bbbabbcccbcccbbbbbbbbbbbbbbdddddddddbccc
bbbabbbbbbbbbbbbbbbbbbbbbbbdddddddddbccc
bbbabbbbbbbbbbbbbbbbbbbbbbbbbdddddbbbbbc
bbbabbbbbbbbbbbbbbbbbbbbbbbbbdddddbbcccc
bbbabbbbbbbcbbbbbbbbbbbbbbbbbbbbbbbbcccc
cbbabbcccbbbbbbbcbbbbbbbbbbbbbbbbbbbbccc
cbbabbbccbbbbbcccbbbbbbbbbbbbbbbbbbbbccc
cbbabbbccbbbbbbccbbblllllbbbbbbbbbbbbccc
cbbabbbccbbbbbbccbbblllllbbbbbbbbbcccccc
bbbijkbbbbbbbbbcbblllllllllbbbbbbbcccccc
bbbbbikbbbbbcccccblllllllllbbcbbbbcccccc
cccbbbabbbbbccccbblllllllllbbccbbccccccc
cccbbbabbbbcccccbblllllllllbcccbbccccccc
cccbbbabbbbcccccbblllllllllbbccccccccccc
ccccbbabbbbccccccblllllllllbbccccccccccc
ccccbbabbbcccccccblllllllllbbccccccccccc
ccbbbmefbbbccccbbblllllllllbbccccccccccc
ccbbbnghbbcccccbbblllllllllbbccccccccccc
cccbbbabbbccccccbblllllllllbbccccccccccc
cccbbbabbbccccccbblllllllllbcccccccccccc
ccbbojpbbbbcccccbblllllllllbbbcccccccccc
cbbbabbbbccccccccblllllllllbbbccccccccqq
cbbbabbbbbcccccccblllllllllbbbccccccccqq
"}
