"a" = (/turf/simulated/floor/planet/jungle/path,/area/jungle)
"b" = (/turf/simulated/floor/planet/jungle/clear,/area/jungle)
"c" = (/turf/simulated/floor/plating,/area/jungle)
"d" = (/turf/simulated/wall,/area/jungle)
"e" = (/obj/structure/girder,/turf/simulated/floor/plating,/area/jungle)
"f" = (/obj/effect/decal/cleanable/ash,/turf/simulated/floor/plating,/area/jungle)
"g" = (/obj/structure/grille,/obj/structure/window/reinforced/tinted,/obj/structure/window/reinforced/tinted{dir = 8; icon_state = "twindow"},/obj/structure/window/reinforced/tinted{dir = 4; icon_state = "twindow"},/obj/structure/window/reinforced/tinted{dir = 1},/obj/machinery/atmospherics/pipe/simple/hidden/scrubbers,/turf/simulated/floor/plating,/area/jungle)
"h" = (/obj/machinery/door/airlock/research{name = "Xenobiology"; req_access = list(55)},/turf/simulated/floor{icon_state = "white"},/area/jungle)
"i" = (/obj/structure/grille,/obj/structure/window/reinforced/tinted,/obj/structure/window/reinforced/tinted{dir = 4; icon_state = "twindow"},/obj/structure/window/reinforced/tinted{dir = 1},/obj/structure/window/reinforced/tinted{dir = 8; icon_state = "twindow"},/obj/machinery/atmospherics/pipe/simple/hidden/supply,/turf/simulated/floor/plating,/area/jungle)
"j" = (/obj/structure/table/woodentable,/obj/effect/decal/cleanable/blood,/obj/effect/decal/cleanable/cobweb,/obj/item/weapon/screwdriver,/turf/simulated/floor/plating,/area/jungle)
"k" = (/obj/item/weapon/broken_bottle,/turf/simulated/floor,/area/jungle)
"l" = (/obj/effect/decal/cleanable/liquid_fuel,/obj/effect/decal/cleanable/ash,/turf/simulated/floor,/area/jungle)
"m" = (/obj/item/weapon/cigbutt,/turf/simulated/floor/plating,/area/jungle)
"n" = (/turf/simulated/floor,/area/jungle)
"o" = (/obj/effect/decal/cleanable/liquid_fuel,/turf/simulated/floor,/area/jungle)
"p" = (/obj/structure/table/woodentable,/turf/simulated/floor,/area/jungle)
"q" = (/obj/item/stack/material/glass,/turf/simulated/floor,/area/jungle)
"r" = (/obj/item/weapon/material/shard{icon_state = "small"},/turf/simulated/floor/planet/jungle/path,/area/jungle)
"s" = (/obj/structure/table/woodentable,/turf/simulated/floor/plating,/area/jungle)
"t" = (/obj/structure/bed/chair{dir = 8},/turf/simulated/floor/plating,/area/jungle)
"u" = (/turf/simulated/wall/r_wall,/area/jungle)
"v" = (/obj/item/weapon/material/shard,/obj/item/weapon/caution,/turf/simulated/floor/plating,/area/jungle)
"w" = (/obj/structure/disposalpipe/broken,/turf/simulated/floor/plating,/area/jungle)
"x" = (/obj/structure/grille,/obj/structure/window/reinforced,/obj/structure/window/reinforced{dir = 8},/obj/structure/window/reinforced{dir = 1},/obj/structure/window/reinforced{dir = 4},/turf/simulated/floor/plating,/area/jungle)
"y" = (/obj/item/weapon/circuitboard/broken,/turf/simulated/floor/plating,/area/jungle)
"z" = (/obj/structure/grille,/obj/structure/window/reinforced,/obj/structure/window/reinforced{dir = 1},/obj/structure/window/reinforced{dir = 4},/obj/item/weapon/material/shard{icon_state = "medium"},/turf/simulated/floor/plating,/area/jungle)
"A" = (/obj/structure/grille,/obj/structure/window/reinforced{dir = 8},/obj/structure/window/reinforced{dir = 1},/obj/structure/window/reinforced{dir = 4},/turf/simulated/floor/plating,/area/jungle)
"B" = (/obj/effect/decal/cleanable/blood/xeno,/turf/simulated/floor,/area/jungle)
"C" = (/obj/structure/grille,/obj/structure/window/reinforced{dir = 8},/obj/structure/window/reinforced{dir = 4},/obj/item/weapon/material/shard{icon_state = "medium"},/turf/simulated/floor/plating,/area/jungle)
"D" = (/obj/item/stack/rods{amount = 25},/turf/simulated/floor/plating,/area/jungle)
"E" = (/obj/structure/grille{density = 0; icon_state = "brokengrille"},/obj/item/stack/rods{amount = 25},/turf/simulated/floor/plating,/area/jungle)
"F" = (/obj/effect/decal/cleanable/cobweb2{tag = "icon-cobweb1"; icon_state = "cobweb1"},/turf/simulated/floor/reinforced,/area/jungle)
"G" = (/obj/effect/decal/cleanable/blood/gibs/xeno/body,/turf/simulated/floor/reinforced,/area/jungle)
"H" = (/turf/simulated/floor/reinforced,/area/jungle)
"I" = (/obj/item/weapon/material/shard,/obj/item/weapon/material/shard{icon_state = "medium"},/turf/simulated/floor/reinforced,/area/jungle)
"J" = (/obj/item/weapon/material/shard,/turf/simulated/floor/reinforced,/area/jungle)
"K" = (/obj/structure/closet,/turf/simulated/floor/reinforced,/area/jungle)

(1,1,1) = {"
aaaaaaaaaaaaaa
abbaaaaaacccaa
bbbbbbbbbcccba
ddddefeddghida
djklccmnncnnda
dnoocaaaaapnda
dqcoraaaacssda
dncaaaaaccstda
ucvccccnnnwnda
uxyzeABCuDnEua
uFGHuIHJuHHHua
uHHHuHHKuHHHua
uHHHuHHHuHHHua
uuuuuuuuuuuuua
"}
