"a" = (/turf/simulated/floor/planet/jungle/templatethick,/area/planet/jungle)
"b" = (/turf/simulated/floor/planet/jungle/rock,/area/planet/jungle)
"c" = (/turf/simulated/floor/planet/jungle/clear/underground,/area/planet/jungle)
"d" = (/obj/effect/spider,/turf/simulated/floor/planet/jungle/clear/underground,/area/planet/jungle)
"e" = (/obj/random/loot,/turf/simulated/floor/planet/jungle/clear/underground,/area/planet/jungle)
"f" = (/obj/effect/decal/cleanable/dirt,/turf/simulated/floor/planet/jungle/clear/underground,/area/planet/jungle)
"g" = (/obj/random/maintenance/clean,/turf/simulated/floor/planet/jungle/clear/underground,/area/planet/jungle)
"h" = (/obj/random/loot,/obj/structure/closet/crate,/turf/simulated/floor/planet/jungle/clear/underground,/area/planet/jungle)
"i" = (/obj/effect/spider,/obj/effect/decal/cleanable/cobweb,/obj/effect/decal/cleanable/dirt,/turf/simulated/floor/planet/jungle/clear/underground,/area/planet/jungle)

(1,1,1) = {"
aaaaaaabbbbaaaa
aaaaabbbbbbbaaa
aaabbbbccccbbba
aabbbbccccccbbb
aabbcccccccccbb
abbdccccbccccbb
abcccccbbbcccbb
abcbbcbbbecccbb
abcfbbbbgccgbba
abbfffbbbhcbbaa
aabbbfbbbbbbaaa
aaabbibbbbbaaaa
aaaaaaaaaaaaaaa
"}
