"a" = (/turf/space,/area/template_noop)
"b" = (/turf/unsimulated/wall/urist/other/destructable{icon_state = "1,0"; dir = 1},/area/template_noop)
"c" = (/turf/unsimulated/wall/urist/other/destructable{icon_state = "1,0"; dir = 6},/area/template_noop)
"d" = (/turf/unsimulated/wall/urist/other/destructable{icon_state = "1,0"; dir = 6},/turf/unsimulated/wall/urist/other/destructable{icon_state = "9,15"; dir = 6},/area/template_noop)
"e" = (/turf/unsimulated/wall/urist/other/destructable{icon_state = "1,0"; dir = 4},/area/template_noop)
"f" = (/turf/unsimulated/wall/urist/other/destructable{icon_state = "1,0"; dir = 9},/area/template_noop)
"g" = (/turf/unsimulated/floor/uristturf/other/scom/destructable{icon_state = "5,1"},/turf/unsimulated/wall/urist/other/see/destructable{icon_state = "8,15"},/area/template_noop)
"h" = (/turf/unsimulated/floor/uristturf/other/scom/destructable{icon_state = "5,1"},/area/template_noop)
"i" = (/turf/unsimulated/floor/uristturf/other/scom/destructable{icon_state = "9,7"},/area/template_noop)
"j" = (/turf/unsimulated/floor/uristturf/other/scom/destructable{icon_state = "5,1"},/turf/unsimulated/wall/urist/other/see/destructable{icon_state = "8,15"; dir = 1},/area/template_noop)
"k" = (/turf/unsimulated/wall/urist/other/destructable{icon_state = "1,0"; dir = 10},/area/template_noop)
"l" = (/turf/unsimulated/floor/uristturf/other/scom/destructable{icon_state = "5,1"},/turf/unsimulated/wall/urist/other/see/destructable{icon_state = "8,14"},/area/template_noop)
"m" = (/turf/unsimulated/floor/uristturf/other/scom/destructable{icon_state = "5,1"},/turf/unsimulated/wall/urist/other/see/destructable{icon_state = "8,14"; dir = 1},/area/template_noop)
"n" = (/turf/unsimulated/wall/urist/other/destructable{icon_state = "1,0"; dir = 2},/area/template_noop)
"o" = (/turf/unsimulated/wall/urist/other/destructable{icon_state = "1,0.1.1.1.1.1.1.1.1"; dir = 1},/area/template_noop)
"p" = (/turf/unsimulated/wall/urist/other/destructable{icon_state = "1,0"; dir = 8},/area/template_noop)
"q" = (/turf/unsimulated/wall/urist/other/destructable{icon_state = "3,15"; dir = 9},/area/template_noop)
"r" = (/turf/unsimulated/wall/urist/other/destructable{icon_state = "3,15"; dir = 2},/area/template_noop)
"s" = (/turf/unsimulated/floor/uristturf/other/scom/destructable{icon_state = "3,1"},/area/template_noop)
"t" = (/turf/unsimulated/wall/urist/other/destructable{icon_state = "3,15"; dir = 6},/area/template_noop)
"u" = (/turf/unsimulated/wall/urist/other/destructable{icon_state = "3,15"; dir = 4},/area/template_noop)
"v" = (/turf/unsimulated/wall/urist/other/see/destructable{icon_state = "0,14"},/area/template_noop)
"w" = (/turf/unsimulated/floor/uristturf/other/scom/destructable{icon_state = "0,15"},/area/template_noop)
"x" = (/turf/unsimulated/floor/uristturf/other/scom/destructable{icon_state = "0,15.1"},/area/template_noop)
"y" = (/turf/unsimulated/floor/uristturf/other/scom/destructable{icon_state = "1,15"},/area/template_noop)
"z" = (/turf/unsimulated/wall/urist/other/see/destructable{icon_state = "1,14"},/area/template_noop)
"A" = (/turf/unsimulated/wall/urist/other/destructable{icon_state = "3,15"; dir = 8},/area/template_noop)
"B" = (/turf/unsimulated/wall/urist/other/destructable{icon_state = "5,14"},/area/template_noop)
"C" = (/turf/unsimulated/wall/urist/other/destructable{icon_state = "4,14"},/area/template_noop)
"D" = (/turf/unsimulated/wall/urist/other/see/destructable{icon_state = "2,12"},/area/template_noop)
"E" = (/turf/unsimulated/wall/urist/other/see/destructable{icon_state = "0,11"},/area/template_noop)
"F" = (/turf/unsimulated/wall/urist/other/see/destructable{icon_state = "1,10"},/area/template_noop)
"G" = (/turf/unsimulated/wall/urist/other/see/destructable{icon_state = "0,10"},/area/template_noop)
"H" = (/turf/unsimulated/wall/urist/other/see/destructable{icon_state = "1,14"},/turf/unsimulated/wall/urist/other/see/destructable{icon_state = "6,14"; dir = 4},/area/template_noop)
"I" = (/turf/unsimulated/wall/urist/other/see/destructable{icon_state = "2,12"},/turf/unsimulated/wall/urist/other/see/destructable{icon_state = "6,14"; dir = 4},/area/template_noop)
"J" = (/turf/unsimulated/wall/urist/other/destructable{icon_state = "3,0"},/turf/unsimulated/wall/urist/other/see/destructable{icon_state = "6,14"; dir = 4},/area/template_noop)
"K" = (/turf/unsimulated/wall/urist/other/see/destructable{icon_state = "0,11"},/turf/unsimulated/wall/urist/other/see/destructable{icon_state = "6,14"; dir = 4},/area/template_noop)
"L" = (/turf/unsimulated/wall/urist/other/see/destructable{icon_state = "0,14"},/turf/unsimulated/wall/urist/other/see/destructable{icon_state = "6,14"; dir = 4},/area/template_noop)
"M" = (/turf/unsimulated/wall/urist/other/destructable{icon_state = "3,0"},/area/template_noop)
"N" = (/turf/unsimulated/wall/urist/other/see/destructable{icon_state = "3,0"},/area/template_noop)
"O" = (/turf/unsimulated/wall/urist/other/destructable{icon_state = "3,15"; dir = 5},/area/template_noop)
"P" = (/turf/unsimulated/wall/urist/other/destructable{icon_state = "123456"; dir = 8},/area/template_noop)
"Q" = (/turf/unsimulated/wall/urist/other/destructable{icon_state = "3,15"; dir = 1},/area/template_noop)
"R" = (/turf/unsimulated/wall/urist/other/destructable{icon_state = "3,15"; dir = 10},/area/template_noop)
"S" = (/turf/unsimulated/floor/uristturf/other/scom/destructable{icon_state = "2,14"},/area/template_noop)
"T" = (/turf/unsimulated/floor/uristturf/other/scom/destructable{icon_state = "2,14"; dir = 6},/area/template_noop)
"U" = (/turf/unsimulated/floor/uristturf/other/scom/destructable{icon_state = "2,14"; dir = 1},/area/template_noop)

(1,1,1) = {"
aaaaabccddcceaaaaa
aaaaafghiihjkaaaaa
aaaaaflhiihmkaaaaa
aaaaafghiihjkaaaaa
aaaaaflhiihmkaaaaa
aaaaanohiihopaaaaa
aaaaaafhiihkaaaaaa
aaaaaafhiihkaaaaaa
aaaaaafhiihkaaaaaa
qrrrrrrsrrsrrrrrrt
uvwxyzuhAuhAvwxyzA
uvwxyzuhAuhAvwxyzA
uvwxyzuhAuhAvwxyzA
uvwxyzBhCBhCvwxyzA
uvwxyzDiEDiEvwxyzA
uvwxyzDiEDiEvwxyzA
uvwxyzFiEDiEvwxyzA
uvwxyzDiEDiEvwxyzA
uvwxyzDiEDiEvwxyzA
uvwxyzDiEDiGvwxyzA
uvwxyzFiEDiEvwxyzA
uvwxyzDiEDiEvwxyzA
uvwxyzDiEDiGvwxyzA
uvwxyzDiEDiEvwxyzA
uvwxyzFiEDiGvwxyzA
uvwxyzDiEDiEvwxyzA
uvwxyzDiEDiEvwxyzA
uvwxyzDiEDiEvwxyzA
uvwxyzFiEDiGvwxyzA
uvwxyzDsEDsEvwxyzA
uvwxxxxxxxxxxxxyzA
uvwxxxxxxxxxxxxyzA
uvwxyHIJKIJKLwxyzA
uvwxyzDMEDNEvwxyzA
uvwxyzDMEDNEvwxyzA
OPwxyPQQQQQQPwxyPR
auSTUAaaaaaauSTUAa
auSTUAaaaaaauSTUAa
"}
