"a" = (/turf/unsimulated/wall/urist/other/destructable{tag = "icon-3,15 (NORTHWEST)"; icon_state = "3,15"; dir = 9},/area/shuttle/assault/a1/station)
"b" = (/turf/unsimulated/wall/urist/other/destructable{tag = "icon-3,15"; icon_state = "3,15"; dir = 2},/area/shuttle/assault/a1/station)
"c" = (/turf/unsimulated/wall/urist/other/destructable{tag = "icon-3,15 (SOUTHEAST)"; icon_state = "3,15"; dir = 6},/area/shuttle/assault/a1/station)
"d" = (/turf/unsimulated/wall/urist/other/destructable{tag = "icon-3,15 (EAST)"; icon_state = "3,15"; dir = 4},/area/shuttle/assault/a1/station)
"e" = (/turf/unsimulated/wall/urist/other/destructable{tag = "icon-4,14"; icon_state = "4,14"},/area/shuttle/assault/a1/station)
"f" = (/turf/unsimulated/wall/urist/other/see/destructable{tag = "icon-0,14"; icon_state = "0,14"},/area/shuttle/assault/a1/station)
"g" = (/turf/unsimulated/floor/uristturf/other/scom/destructable{tag = "icon-0,15"; icon_state = "0,15"},/area/shuttle/assault/a1/station)
"h" = (/turf/unsimulated/floor/uristturf/other/scom/destructable{tag = "icon-0,15.1"; icon_state = "0,15.1"},/area/shuttle/assault/a1/station)
"i" = (/turf/unsimulated/floor/uristturf/other/scom/destructable{tag = "icon-1,15"; icon_state = "1,15"},/area/shuttle/assault/a1/station)
"j" = (/turf/unsimulated/wall/urist/other/see/destructable{tag = "icon-1,14"; icon_state = "1,14"},/area/shuttle/assault/a1/station)
"k" = (/turf/unsimulated/wall/urist/other/destructable{tag = "icon-5,14"; icon_state = "5,14"},/area/shuttle/assault/a1/station)
"l" = (/turf/unsimulated/wall/urist/other/destructable{tag = "icon-3,15 (WEST)"; icon_state = "3,15"; dir = 8},/area/shuttle/assault/a1/station)
"m" = (/turf/unsimulated/wall/urist/other/see/destructable{tag = "icon-2,11"; icon_state = "2,11"},/area/shuttle/assault/a1/station)
"n" = (/turf/unsimulated/floor/uristturf/other/scom/destructable{tag = "icon-0,13"; icon_state = "0,13"},/area/shuttle/assault/a1/station)
"o" = (/turf/unsimulated/floor/uristturf/other/scom/destructable{tag = "icon-1,13"; icon_state = "1,13"},/area/shuttle/assault/a1/station)
"p" = (/turf/unsimulated/wall/urist/other/see/destructable{tag = "icon-0,12"; icon_state = "0,12"},/area/shuttle/assault/a1/station)
"q" = (/turf/unsimulated/wall/urist/other/see/destructable{tag = "icon-0,11"; icon_state = "0,11"},/area/shuttle/assault/a1/station)
"r" = (/turf/unsimulated/wall/urist/other/see/destructable{tag = "icon-2,13"; icon_state = "2,13"},/area/shuttle/assault/a1/station)
"s" = (/turf/unsimulated/wall/urist/other/see/destructable{tag = "icon-3,13"; icon_state = "3,13"},/area/shuttle/assault/a1/station)
"t" = (/turf/unsimulated/wall/urist/other/see/destructable{tag = "icon-1,10"; icon_state = "1,10"},/area/shuttle/assault/a1/station)
"u" = (/turf/unsimulated/wall/urist/other/see/destructable{tag = "icon-2,12"; icon_state = "2,12"},/area/shuttle/assault/a1/station)
"v" = (/turf/unsimulated/wall/urist/other/destructable{tag = "icon-3,15 (NORTHEAST)"; icon_state = "3,15"; dir = 5},/area/shuttle/assault/a1/station)
"w" = (/turf/unsimulated/wall/urist/other/destructable{tag = "icon-3,15 (NORTH)"; icon_state = "3,15"; dir = 1},/area/shuttle/assault/a1/station)
"x" = (/turf/unsimulated/wall/urist/other/destructable{tag = "icon-123456 (WEST)"; icon_state = "123456"; dir = 8},/area/shuttle/assault/a1/station)
"y" = (/turf/unsimulated/floor/uristturf/other/scom/destructable{tag = "icon-2,14"; icon_state = "2,14"},/area/shuttle/assault/a1/station)
"z" = (/turf/unsimulated/floor/uristturf/other/scom/destructable{tag = "icon-2,14 (SOUTHEAST)"; icon_state = "2,14"; dir = 6},/area/shuttle/assault/a1/station)
"A" = (/turf/unsimulated/floor/uristturf/other/scom/destructable{tag = "icon-2,14 (NORTH)"; icon_state = "2,14"; dir = 1},/area/shuttle/assault/a1/station)
"B" = (/turf/unsimulated/wall/urist/other/destructable{tag = "icon-3,15 (SOUTHWEST)"; icon_state = "3,15"; dir = 10},/area/shuttle/assault/a1/station)
"C" = (/turf/template_noop,/area/template_noop)

(1,1,1) = {"
abbbbbbbc
defghijkl
dmnghiopl
dqrghistl
dmnghiopl
dqrghistl
dmnghiopl
dqrghistl
dmnghiopl
dqrghistl
dmnghiopl
dqrghistl
dqfghijul
vwxyzAxwB
CCdyzAlCC
"}
