"aa" = (/turf/simulated/floor/airless,/area/space)
"ab" = (/turf/space,/area/space)
"ac" = (/obj/effect/landmark/map_data{height = 2},/turf/simulated/floor/airless,/area/space)
"ad" = (/turf/space,/turf/simulated/shuttle/wall/corner/smoothwhite/nw,/area/shuttle/naval1/centcom)
"ae" = (/obj/structure/grille,/obj/structure/window/reinforced{dir = 8},/obj/structure/window/reinforced{dir = 1},/obj/structure/window/reinforced,/turf/space,/area/shuttle/naval1/centcom)
"af" = (/obj/structure/grille,/obj/structure/window/reinforced{dir = 1},/obj/structure/window/reinforced,/turf/space,/area/shuttle/naval1/centcom)
"ag" = (/obj/structure/grille,/obj/structure/window/reinforced{dir = 1},/obj/structure/window/reinforced,/obj/structure/window/reinforced{dir = 4},/turf/space,/area/shuttle/naval1/centcom)
"ah" = (/turf/space,/turf/simulated/shuttle/wall/corner/smoothwhite/ne,/area/shuttle/naval1/centcom)
"ai" = (/turf/simulated/shuttle/wall{icon_state = "swall_straight"; dir = 4},/area/shuttle/naval1/centcom)
"aj" = (/turf/simulated/shuttle/wall,/area/shuttle/naval1/centcom)
"ak" = (/obj/machinery/porta_turret,/turf/simulated/floor/shuttle/white,/area/shuttle/naval1/centcom)
"al" = (/turf/simulated/floor/shuttle/white,/area/shuttle/naval1/centcom)
"am" = (/obj/structure/grille,/obj/structure/window/reinforced{dir = 1},/obj/structure/window/reinforced{dir = 4},/obj/structure/window/reinforced{dir = 8},/turf/space,/area/shuttle/naval1/centcom)
"an" = (/obj/structure/shuttle/engine/propulsion/burst{dir = 4},/turf/space,/area/shuttle/naval1/centcom)
"ao" = (/obj/structure/window/reinforced{dir = 4},/obj/structure/shuttle/engine/heater{dir = 8},/turf/simulated/floor/plating/airless,/area/shuttle/naval1/centcom)
"ap" = (/turf/simulated/floor/shuttle/yellow,/area/shuttle/naval1/centcom)
"aq" = (/obj/machinery/door/airlock/hatch,/turf/simulated/floor/shuttle/yellow,/area/shuttle/naval1/centcom)
"ar" = (/obj/structure/grille,/obj/structure/window/reinforced,/obj/structure/window/reinforced{dir = 4},/obj/structure/window/reinforced{dir = 8},/turf/space,/area/shuttle/naval1/centcom)
"as" = (/obj/machinery/door/airlock/hatch,/turf/simulated/floor/shuttle/white,/area/shuttle/naval1/centcom)
"at" = (/obj/machinery/door/airlock/external{hackProof = 1; heat_proof = 1; req_access = list("ACCESS_CENT_GENERAL"); autoset_access = 0},/turf/simulated/floor/shuttle/white,/area/shuttle/naval1/centcom)
"au" = (/obj/machinery/door/airlock/hatch{hackProof = 1; heat_proof = 1; req_access = list("ACCESS_CENT_GENERAL"); autoset_access = 0},/turf/simulated/floor/shuttle/yellow,/area/shuttle/naval1/centcom)
"av" = (/obj/machinery/door/airlock/hatch{hackProof = 1; req_access = list("ACCESS_CENT_GENERAL"); autoset_access = 0},/turf/simulated/floor/shuttle/white,/area/shuttle/naval1/centcom)
"aw" = (/turf/simulated/shuttle/wall{icon_state = "swall_straight"; dir = 1},/area/shuttle/naval1/centcom)
"ax" = (/obj/structure/shuttle/engine/propulsion/burst{icon_state = "propulsion"; dir = 8},/turf/space,/area/shuttle/naval1/centcom)
"ay" = (/obj/structure/window/reinforced{dir = 4},/obj/structure/shuttle/engine/heater{icon_state = "heater"; dir = 8},/turf/simulated/floor/plating/airless,/area/shuttle/naval1/centcom)
"az" = (/obj/structure/closet/crate/secure/phoron,/obj/item/tank/phoron,/turf/simulated/floor/shuttle/yellow,/area/shuttle/naval1/centcom)
"aA" = (/obj/structure/closet,/obj/item/clothing/suit/space/naval,/obj/item/clothing/head/helmet/space/naval,/obj/item/gun/energy/lasercannon,/obj/item/clothing/head/helmet/space/void/commando,/obj/item/clothing/suit/space/void/commando,/obj/item/clothing/gloves/thick/combat,/turf/simulated/floor/shuttle/white,/area/shuttle/naval1/centcom)
"aB" = (/obj/machinery/door/airlock/external{hackProof = 1; heat_proof = 1; req_access = list("ACCESS_CENT_GENERAL"); autoset_access = 0},/turf/simulated/floor/shuttle/black,/area/shuttle/naval1/centcom)
"aC" = (/obj/structure/reagent_dispensers/watertank,/turf/simulated/floor/shuttle/yellow,/area/shuttle/naval1/centcom)
"aD" = (/obj/structure/window/reinforced{dir = 1},/obj/structure/window/reinforced,/obj/structure/bed/nice,/turf/simulated/floor/shuttle/white,/area/shuttle/naval1/centcom)
"aE" = (/obj/structure/bed/chair/urist/shuttle{icon_state = "shuttlechair"; dir = 4},/turf/simulated/floor/shuttle/blue,/area/shuttle/naval1/centcom)
"aF" = (/turf/simulated/floor/shuttle/blue,/area/shuttle/naval1/centcom)
"aG" = (/obj/machinery/computer/modular/preset/security,/turf/simulated/floor/shuttle/blue,/area/shuttle/naval1/centcom)
"aH" = (/obj/structure/table/standard,/obj/item/storage/firstaid/fire,/obj/item/storage/firstaid/regular{pixel_x = 2; pixel_y = 3},/obj/item/crowbar,/obj/item/extinguisher,/turf/simulated/floor/shuttle/blue,/area/shuttle/naval1/centcom)
"aI" = (/obj/machinery/computer/modular/preset/cardslot/command,/turf/simulated/floor/shuttle/blue,/area/shuttle/naval1/centcom)
"aJ" = (/obj/structure/table/standard,/obj/item/storage/lockbox,/turf/simulated/floor/shuttle/blue,/area/shuttle/naval1/centcom)
"aK" = (/obj/structure/bed/chair,/turf/simulated/floor/shuttle/black,/area/shuttle/naval1/centcom)
"aL" = (/turf/simulated/floor/shuttle/black,/area/shuttle/naval1/centcom)
"aM" = (/turf/simulated/floor/shuttle/black,/turf/simulated/shuttle/wall/corner/smoothwhite/sw,/area/shuttle/naval1/centcom)
"aN" = (/obj/structure/reagent_dispensers/fueltank,/turf/simulated/floor/shuttle/yellow,/area/shuttle/naval1/centcom)
"aO" = (/obj/structure/bed/chair/urist/shuttle{icon_state = "shuttlechair"; dir = 1},/turf/simulated/floor/shuttle/blue,/area/shuttle/naval1/centcom)
"aP" = (/obj/structure/table/standard,/obj/item/device/radio/off,/turf/simulated/floor/shuttle/blue,/area/shuttle/naval1/centcom)
"aQ" = (/obj/structure/artilleryplaceholder{icon_state = "4"},/turf/simulated/floor/shuttle/black,/area/shuttle/naval1/centcom)
"aR" = (/obj/structure/artilleryplaceholder{icon_state = "5"},/turf/simulated/floor/shuttle/black,/area/shuttle/naval1/centcom)
"aS" = (/obj/structure/artilleryplaceholder{icon_state = "3"},/turf/simulated/floor/shuttle/black,/area/shuttle/naval1/centcom)
"aT" = (/obj/structure/artilleryplaceholder{icon_state = "8"},/turf/simulated/floor/shuttle/black,/area/shuttle/naval1/centcom)
"aU" = (/obj/structure/artilleryplaceholder{icon_state = "6"},/turf/simulated/floor/shuttle/black,/area/shuttle/naval1/centcom)
"aV" = (/obj/structure/artilleryplaceholder{icon_state = "7"},/turf/simulated/floor/shuttle/black,/area/shuttle/naval1/centcom)
"aW" = (/obj/structure/artilleryplaceholder{icon_state = "9"},/turf/simulated/floor/shuttle/black,/area/shuttle/naval1/centcom)
"aX" = (/obj/structure/artilleryplaceholder{icon_state = "10"},/turf/simulated/floor/shuttle/black,/area/shuttle/naval1/centcom)
"aY" = (/obj/structure/artilleryplaceholder{icon_state = "11"},/turf/simulated/floor/shuttle/black,/area/shuttle/naval1/centcom)
"aZ" = (/obj/structure/artilleryplaceholder{icon_state = "12"},/turf/simulated/floor/shuttle/black,/area/shuttle/naval1/centcom)
"ba" = (/obj/structure/closet/crate/secure/weapon,/obj/item/gun/energy/laser,/obj/item/gun/energy/ionrifle,/obj/item/gun/energy/gun/small,/obj/item/gun/energy/plasmapistol,/obj/item/gun/energy/lasercannon,/turf/simulated/floor/shuttle/yellow,/area/shuttle/naval1/centcom)
"bd" = (/obj/structure/artilleryplaceholder{icon_state = "16"},/turf/simulated/floor/shuttle/black,/area/shuttle/naval1/centcom)
"be" = (/obj/structure/artilleryplaceholder{icon_state = "17"},/turf/simulated/floor/shuttle/black,/area/shuttle/naval1/centcom)
"bf" = (/obj/structure/artilleryplaceholder{icon_state = "15"},/turf/simulated/floor/shuttle/black,/area/shuttle/naval1/centcom)
"bg" = (/obj/structure/artilleryplaceholder{icon_state = "21"},/turf/simulated/floor/shuttle/black,/area/shuttle/naval1/centcom)
"bh" = (/obj/structure/artilleryplaceholder{icon_state = "18"},/turf/simulated/floor/shuttle/black,/area/shuttle/naval1/centcom)
"bi" = (/obj/structure/artilleryplaceholder{icon_state = "19"},/turf/simulated/floor/shuttle/black,/area/shuttle/naval1/centcom)
"bj" = (/obj/structure/artilleryplaceholder{icon_state = "20"},/turf/simulated/floor/shuttle/black,/area/shuttle/naval1/centcom)
"bk" = (/obj/structure/artilleryplaceholder{icon_state = "22"},/turf/simulated/floor/shuttle/black,/area/shuttle/naval1/centcom)
"bl" = (/obj/structure/artilleryplaceholder{icon_state = "23"},/turf/simulated/floor/shuttle/black,/area/shuttle/naval1/centcom)
"bm" = (/obj/structure/artilleryplaceholder{icon_state = "24"},/turf/simulated/floor/shuttle/black,/area/shuttle/naval1/centcom)
"bn" = (/obj/structure/grille,/obj/structure/window/reinforced{dir = 4},/obj/structure/window/reinforced{dir = 8},/turf/space,/area/shuttle/naval1/centcom)
"bo" = (/obj/structure/table/standard,/obj/item/storage/toolbox/mechanical{pixel_x = -2; pixel_y = -1},/obj/item/stack/material/steel{amount = 50},/obj/item/stack/rods{amount = 50},/obj/item/stack/material/glass{amount = 50},/obj/item/clothing/gloves/insulated,/turf/simulated/floor/shuttle/yellow,/area/shuttle/naval1/centcom)
"bp" = (/obj/structure/bed/chair/urist/shuttle,/turf/simulated/floor/shuttle/blue,/area/shuttle/naval1/centcom)
"bq" = (/obj/structure/table/standard,/obj/item/material/clipboard,/obj/item/pen,/turf/simulated/floor/shuttle/blue,/area/shuttle/naval1/centcom)
"br" = (/obj/structure/artilleryplaceholder/decorative{icon_state = "27"},/turf/simulated/floor/shuttle/black,/area/shuttle/naval1/centcom)
"bs" = (/obj/structure/artilleryplaceholder/decorative{icon_state = "26"},/turf/simulated/floor/shuttle/black,/area/shuttle/naval1/centcom)
"bt" = (/obj/structure/artilleryplaceholder/decorative{icon_state = "29"},/turf/simulated/floor/shuttle/black,/area/shuttle/naval1/centcom)
"bu" = (/obj/structure/artilleryplaceholder/decorative{icon_state = "30"},/obj/machinery/artillerycontrol,/obj/structure/artilleryplaceholder/decorative{icon_state = "28"},/turf/simulated/floor/shuttle/black,/area/shuttle/naval1/centcom)
"bv" = (/obj/structure/artilleryplaceholder/decorative{icon_state = "31"},/turf/simulated/floor/shuttle/black,/area/shuttle/naval1/centcom)
"bw" = (/obj/structure/artilleryplaceholder/decorative{icon_state = "33"},/turf/simulated/floor/shuttle/black,/area/shuttle/naval1/centcom)
"bx" = (/obj/structure/artilleryplaceholder/decorative{icon_state = "34"},/turf/simulated/floor/shuttle/black,/area/shuttle/naval1/centcom)
"by" = (/obj/structure/closet/secure_closet/freezer/fridge,/turf/simulated/floor/shuttle/yellow,/area/shuttle/naval1/centcom)
"bz" = (/obj/machinery/computer/atmos_alert,/turf/simulated/floor/shuttle/blue,/area/shuttle/naval1/centcom)
"bA" = (/obj/structure/table/standard,/obj/machinery/microwave,/turf/simulated/floor/shuttle/blue,/area/shuttle/naval1/centcom)
"bB" = (/obj/structure/table/standard,/obj/item/storage/box/donkpocket_mixed,/turf/simulated/floor/shuttle/blue,/area/shuttle/naval1/centcom)
"bC" = (/obj/machinery/computer/crew,/turf/simulated/floor/shuttle/blue,/area/shuttle/naval1/centcom)
"bD" = (/obj/structure/table/standard,/obj/item/paper_bin,/turf/simulated/floor/shuttle/blue,/area/shuttle/naval1/centcom)
"bE" = (/obj/structure/bed/chair{dir = 1},/turf/simulated/floor/shuttle/black,/area/shuttle/naval1/centcom)
"bF" = (/turf/simulated/floor/shuttle/black,/turf/simulated/shuttle/wall/corner/smoothwhite/nw,/area/shuttle/naval1/centcom)
"bG" = (/turf/space,/turf/simulated/shuttle/wall/corner/smoothwhite/se,/area/shuttle/naval1/centcom)
"bI" = (/obj/structure/closet,/obj/item/clothing/under/rank/centcom_captain,/obj/item/clothing/head/beret/centcom/captain,/obj/item/clothing/gloves/white,/obj/item/clothing/shoes/laceup,/obj/item/gun/energy/gun/small,/turf/simulated/floor/shuttle/white,/area/shuttle/naval1/centcom)
"bJ" = (/turf/space,/turf/simulated/shuttle/wall/corner/smoothwhite/sw,/area/shuttle/naval1/centcom)

(1,1,1) = {"
ababababababababababababababababababadaeafafagahabababababababababababababababab
abababababababababadaiaiaiaiaiaiaiaiajakalakalamabababababababababababababababab
abababababababababanaoapapapapapapapaqalalalakarabababababababababababababababab
abababadaiaiaiaiaiaiaiaiaiaiaiaiaqaiaiasaiaiaiaiaiaiaiatatahabababababababababab
adaiaiajapapaualalalavalalalalalalalalalalalalalalalalalalawabababababababababab
axayapawapazawaAalaAajaiaiaiaiaiasaiaiaiaiasaiajaiaiaiavavajaiaiaiaiaBaBaiaiahab
axayapawapaCawaDalaDawaEaEaEaEaEaFaGaHaHaIaFaJawaKaKaLaLaLaLaLaLaLaLaLaLaLaLaMah
axayapawapaNawaDalaDawaFaFaFaFaFaFaOaFaFaOaFaPawaLaLaLaQaRaSaTaUaVaTaWaXaYaZaLam
axayapaqapbaawaDalaDawaEaEaEaEaEaFaFaFaFaFaEaFawaLaLaLbdbebfbgbhbibjbgbkblbmaLbn
axayapawapboawaDalaDawaFaFaFaFaFaFbpaFaFbpaFbqawaLaLaLbrbsbsaLbtbubvaLbwbxaLaLar
axayapawapbyawaDalaDawaEaEaEaEaEaFbzbAbBbCaFbDawbEbEaLaLaLaLaLaLaLaLaLaLaLaLbFbG
axayapawapapawbIalbIajaiaiaiaiaiasaiaiaiaiasaiajaiaiaiavavajaiaiaiaiaBaBaiaibGab
bJaiaiajapapaualalalavalalalalalalalalalalalalalalalalalalawabababababababababab
abababbJaiaiaiaiaiaiaiaiaiaiaiaiaqaiaiasaiaiaiaiaiaiaiatatbGabababababababababab
abababababababababanaoapapapapapapapaqalalalakamabababababababababababababababab
abababababababababbJaiaiaiaiaiaiaiaiajakalakalarabababababababababababababababab
ababababababababababababababababababbJaeafafagbGabababababababababababababababab
"}
(1,1,2) = {"
abababababababababababababababababababababababababababababababababababababababab
abababababababababababababababababababababababababababababababababababababababab
abababababababababababababababababababababababababababababababababababababababab
abababababababababababababababababababababababababababababababababababababababab
abababababababababababababababababababababababababababababababababababababababab
abababababababababababababababababababababababababababababababababababababababab
abababababababababababababababababababababababababababababababababababababababab
abababababababababababababababababababababababababababababababababababababababab
aaaaaaaaaaaaaaaaaaaaabababababababababababababababababababababababababababababab
aaaaaaaaaaaaaaaaaaaaabababababababababababababababababababababababababababababab
aaaaaaaaaaaaaaaaaaaaabababababababababababababababababababababababababababababab
aaaaaaaaaaaaaaaaaaaaabababababababababababababababababababababababababababababab
aaaaaaaaaaaaaaaaaaaaabababababababababababababababababababababababababababababab
aaaaaaaaaaaaaaaaaaaaabababababababababababababababababababababababababababababab
aaaaaaaaaaaaaaaaaaaaabababababababababababababababababababababababababababababab
aaaaaaaaaaaaaaaaaaaaabababababababababababababababababababababababababababababab
acaaaaaaaaaaaaaaaaaaabababababababababababababababababababababababababababababab
"}
