"aa" = (/turf/simulated/wall/r_wall,/turf/simulated/floor/airless/uristturf,/area/mine/unexplored)
"ab" = (/turf/simulated/wall/r_wall,/area/mine/unexplored)
"ac" = (/obj/structure/window/reinforced,/obj/structure/window/reinforced{dir = 8},/obj/structure/window/reinforced{dir = 4},/obj/structure/window/reinforced{tag = "icon-rwindow (NORTH)"; icon_state = "rwindow"; dir = 1},/obj/structure/grille,/turf/simulated/floor,/area/mine/unexplored)
"ad" = (/obj/machinery/door/airlock/highsecurity,/turf/simulated/floor,/area/mine/unexplored)
"ae" = (/turf/simulated/wall,/area/mine/unexplored)
"af" = (/obj/structure/bed/alien,/obj/item/weapon/bedsheet/syndie,/turf/simulated/floor/wood,/area/mine/unexplored)
"ag" = (/obj/structure/closet,/obj/machinery/light/small{tag = "icon-bulb1 (NORTH)"; icon_state = "bulb1"; dir = 1},/obj/item/clothing/accessory/storage/knifeharness,/obj/item/device/measuring_tape,/turf/simulated/floor/wood,/area/mine/unexplored)
"ah" = (/obj/structure/closet,/obj/machinery/light/small{tag = "icon-bulb1 (NORTH)"; icon_state = "bulb1"; dir = 1},/obj/item/weapon/storage/briefcase,/turf/simulated/floor/wood,/area/mine/unexplored)
"ai" = (/obj/structure/closet,/obj/machinery/light/small{tag = "icon-bulb1 (NORTH)"; icon_state = "bulb1"; dir = 1},/obj/random/contraband,/obj/random/contraband,/turf/simulated/floor/wood,/area/mine/unexplored)
"aj" = (/obj/structure/bed/alien,/obj/item/weapon/bedsheet/syndie,/obj/random/plushie,/turf/simulated/floor/wood,/area/mine/unexplored)
"ak" = (/obj/structure/bookcase/manuals/medical,/turf/simulated/floor/wood{tag = "icon-wood-broken"; icon_state = "wood-broken"},/area/mine/unexplored)
"al" = (/obj/machinery/light/small{tag = "icon-bulb1 (NORTH)"; icon_state = "bulb1"; dir = 1},/obj/structure/bookcase,/turf/simulated/floor/wood,/area/mine/unexplored)
"am" = (/obj/structure/bookcase,/turf/simulated/floor/wood{tag = "icon-wood-broken5"; icon_state = "wood-broken5"},/area/mine/unexplored)
"an" = (/turf/simulated/floor/tiled/dark,/area/mine/unexplored)
"ao" = (/obj/structure/bed/alien,/obj/item/weapon/bedsheet/syndie,/mob/living/simple_animal/hostile/urist/skrellterrorist,/turf/simulated/floor/wood,/area/mine/unexplored)
"ap" = (/turf/simulated/floor/wood,/area/mine/unexplored)
"aq" = (/obj/structure/dresser,/obj/effect/decal/cleanable/cobweb2,/turf/simulated/floor/wood,/area/mine/unexplored)
"ar" = (/obj/structure/bed/chair/comfy/brown{tag = "icon-comfychair_preview (EAST)"; icon_state = "comfychair_preview"; dir = 4},/obj/effect/decal/cleanable/dirt,/mob/living/simple_animal/hostile/urist/skrellterrorist,/turf/simulated/floor/wood,/area/mine/unexplored)
"as" = (/obj/structure/table/woodentable,/obj/item/device/flashlight/lamp,/turf/simulated/floor/wood,/area/mine/unexplored)
"at" = (/obj/structure/bed/chair/comfy/brown{tag = "icon-comfychair_preview (WEST)"; icon_state = "comfychair_preview"; dir = 8},/mob/living/simple_animal/hostile/urist/skrellterrorist,/turf/simulated/floor/wood,/area/mine/unexplored)
"au" = (/obj/structure/closet/emsuits,/obj/structure/closet/walllocker/emerglocker{pixel_y = -32},/obj/effect/floor_decal/industrial/hatch,/turf/simulated/floor/tiled/dark,/area/mine/unexplored)
"av" = (/obj/structure/dispenser,/obj/effect/floor_decal/industrial/hatch,/turf/simulated/floor/tiled/dark,/area/mine/unexplored)
"aw" = (/obj/structure/closet,/obj/random/contraband,/obj/item/weapon/cane,/turf/simulated/floor/wood,/area/mine/unexplored)
"ax" = (/obj/structure/bed/chair/wood{tag = "icon-wooden_chair (EAST)"; icon_state = "wooden_chair"; dir = 4},/obj/effect/floor_decal/spline/fancy/wood{tag = "icon-spline_fancy (NORTHWEST)"; icon_state = "spline_fancy"; dir = 9},/turf/simulated/floor/tiled/dark,/area/mine/unexplored)
"ay" = (/obj/structure/table/woodentable,/obj/effect/floor_decal/spline/fancy/wood{dir = 1},/turf/simulated/floor/tiled/dark,/area/mine/unexplored)
"az" = (/obj/structure/table/woodentable,/obj/random/contraband,/obj/effect/floor_decal/spline/fancy/wood{dir = 1},/turf/simulated/floor/tiled/dark,/area/mine/unexplored)
"aA" = (/obj/structure/table/woodentable,/obj/item/weapon/dice,/obj/item/weapon/folder,/obj/effect/floor_decal/spline/fancy/wood{dir = 1},/turf/simulated/floor/tiled/dark,/area/mine/unexplored)
"aB" = (/obj/structure/bed/chair/wood{tag = "icon-wooden_chair (WEST)"; icon_state = "wooden_chair"; dir = 8},/obj/effect/floor_decal/spline/fancy/wood{dir = 5},/turf/simulated/floor/tiled/dark,/area/mine/unexplored)
"aC" = (/obj/machinery/space_heater,/obj/structure/extinguisher_cabinet{pixel_x = 32},/turf/simulated/floor/wood,/area/mine/unexplored)
"aD" = (/obj/structure/bed/chair/comfy/brown{tag = "icon-comfychair_preview (EAST)"; icon_state = "comfychair_preview"; dir = 4},/turf/simulated/floor/wood,/area/mine/unexplored)
"aE" = (/obj/structure/table/woodentable,/obj/item/weapon/newspaper,/turf/simulated/floor/wood,/area/mine/unexplored)
"aF" = (/obj/structure/bed/chair/comfy/brown{tag = "icon-comfychair_preview (WEST)"; icon_state = "comfychair_preview"; dir = 8},/turf/simulated/floor/wood,/area/mine/unexplored)
"aG" = (/obj/machinery/door/airlock/highsecurity,/turf/simulated/floor/tiled/dark,/area/mine/unexplored)
"aH" = (/obj/structure/bed/chair/wood{tag = "icon-wooden_chair (EAST)"; icon_state = "wooden_chair"; dir = 4},/obj/item/weapon/cigbutt/cigarbutt,/obj/effect/floor_decal/spline/fancy/wood{dir = 8},/turf/simulated/floor/tiled/dark,/area/mine/unexplored)
"aI" = (/obj/structure/table/woodentable,/obj/item/device/radio/off,/turf/simulated/floor/tiled/dark,/area/mine/unexplored)
"aJ" = (/obj/structure/cult/pylon,/obj/item/weapon/ectoplasm,/turf/simulated/floor/tiled/dark,/area/mine/unexplored)
"aK" = (/obj/structure/table/woodentable,/obj/item/device/flashlight/lamp,/turf/simulated/floor/tiled/dark,/area/mine/unexplored)
"aL" = (/obj/structure/bed/chair/wood{tag = "icon-wooden_chair (WEST)"; icon_state = "wooden_chair"; dir = 8},/obj/effect/floor_decal/spline/fancy/wood{tag = "icon-spline_fancy (EAST)"; icon_state = "spline_fancy"; dir = 4},/turf/simulated/floor/tiled/dark,/area/mine/unexplored)
"aM" = (/obj/machinery/door/unpowered/simple/wood,/turf/simulated/floor{tag = "icon-wood-broken5"; icon_state = "wood-broken5"},/area/mine/unexplored)
"aN" = (/obj/structure/closet/secure_closet/guncabinet,/obj/random/projectile,/obj/random/projectile,/obj/random/projectile,/obj/item/weapon/gun/projectile/automatic/c20r,/turf/simulated/floor/reinforced,/area/mine/unexplored)
"aO" = (/obj/structure/closet/secure_closet/guncabinet,/obj/random/projectile,/obj/random/handgun,/turf/simulated/floor/reinforced,/area/mine/unexplored)
"aP" = (/obj/structure/closet/secure_closet/guncabinet,/obj/random/projectile,/turf/simulated/floor/reinforced,/area/mine/unexplored)
"aQ" = (/turf/simulated/floor/reinforced,/area/mine/unexplored)
"aR" = (/obj/structure/closet,/obj/random/action_figure,/obj/random/bomb_supply,/turf/simulated/floor/wood,/area/mine/unexplored)
"aS" = (/obj/structure/bed/chair/wood{tag = "icon-wooden_chair (EAST)"; icon_state = "wooden_chair"; dir = 4},/obj/effect/floor_decal/spline/fancy/wood{tag = "icon-spline_fancy (SOUTHWEST)"; icon_state = "spline_fancy"; dir = 10},/turf/simulated/floor/tiled/dark,/area/mine/unexplored)
"aT" = (/obj/structure/table/woodentable,/obj/item/weapon/reagent_containers/food/snacks/skrellsnacks,/obj/effect/floor_decal/spline/fancy/wood,/turf/simulated/floor/tiled/dark,/area/mine/unexplored)
"aU" = (/obj/structure/table/woodentable,/obj/item/weapon/gag/BANG{desc = "When you absolutely, positively need a 10mm hole in the other guy. Uses .357 ammo."; name = "mateba"},/obj/effect/floor_decal/spline/fancy/wood,/turf/simulated/floor/tiled/dark,/area/mine/unexplored)
"aV" = (/obj/structure/table/woodentable,/obj/item/weapon/reagent_containers/food/drinks/coffee,/obj/effect/floor_decal/spline/fancy/wood,/turf/simulated/floor/tiled/dark,/area/mine/unexplored)
"aW" = (/obj/structure/bed/chair/wood{tag = "icon-wooden_chair (WEST)"; icon_state = "wooden_chair"; dir = 8},/obj/effect/floor_decal/spline/fancy/wood{dir = 6},/turf/simulated/floor/tiled/dark,/area/mine/unexplored)
"aX" = (/obj/machinery/door/unpowered/simple/wood,/turf/simulated/floor/wood,/area/mine/unexplored)
"aY" = (/obj/structure/extinguisher_cabinet{pixel_x = 32},/turf/simulated/floor/reinforced,/area/mine/unexplored)
"aZ" = (/obj/structure/closet/wardrobe/pjs,/turf/simulated/floor/wood,/area/mine/unexplored)
"ba" = (/obj/structure/noticeboard{pixel_x = -32},/obj/effect/floor_decal/spline/fancy/wood,/turf/simulated/floor/wood,/area/mine/unexplored)
"bb" = (/obj/effect/floor_decal/spline/fancy/wood,/turf/simulated/floor/wood,/area/mine/unexplored)
"bc" = (/mob/living/simple_animal/hostile/urist/skrellterrorist,/turf/simulated/floor/reinforced,/area/mine/unexplored)
"bd" = (/obj/structure/bed/alien,/obj/item/weapon/bedsheet/syndie,/obj/structure/closet/walllocker/emerglocker{pixel_y = -32},/turf/simulated/floor/wood,/area/mine/unexplored)
"be" = (/obj/structure/closet,/obj/machinery/light/small,/obj/random/toolbox,/turf/simulated/floor/wood,/area/mine/unexplored)
"bf" = (/obj/structure/closet,/obj/machinery/light/small,/obj/item/weapon/gun/projectile/automatic/c20r,/turf/simulated/floor/wood,/area/mine/unexplored)
"bg" = (/obj/structure/closet,/obj/machinery/light/small,/obj/item/clothing/mask/balaclava,/turf/simulated/floor/wood,/area/mine/unexplored)
"bh" = (/obj/structure/bed/alien,/obj/item/weapon/bedsheet/syndie,/obj/structure/closet/walllocker/emerglocker{pixel_y = -32},/mob/living/simple_animal/hostile/urist/skrellterrorist,/turf/simulated/floor/wood,/area/mine/unexplored)
"bi" = (/obj/structure/window/reinforced{tag = "icon-rwindow (NORTH)"; icon_state = "rwindow"; dir = 1},/obj/structure/window/reinforced{dir = 4},/obj/effect/floor_decal/corner/paleblue/diagonal,/turf/simulated/floor/tiled/white,/area/mine/unexplored)
"bj" = (/turf/simulated/floor/tiled/white{icon = 'icons/urist/turf/floors+.dmi'; icon_state = "fakestairs"},/area/mine/unexplored)
"bk" = (/obj/structure/sign/securearea{pixel_x = 28},/obj/structure/window/reinforced{tag = "icon-rwindow (NORTH)"; icon_state = "rwindow"; dir = 1},/obj/structure/window/reinforced{dir = 8; health = 1e+006},/obj/effect/floor_decal/corner/paleblue/diagonal,/turf/simulated/floor/tiled/white,/area/mine/unexplored)
"bl" = (/obj/structure/closet/syndicate/suit,/turf/simulated/floor/reinforced,/area/mine/unexplored)
"bm" = (/obj/structure/closet/syndicate,/obj/random/firstaid,/obj/item/weapon/reagent_containers/glass/beaker/vial/random/toxin,/turf/simulated/floor/reinforced,/area/mine/unexplored)
"bn" = (/obj/structure/closet/syndicate,/obj/random/ammo,/obj/random/ammo,/obj/item/weapon/grenade/chem_grenade/teargas,/turf/simulated/floor/reinforced,/area/mine/unexplored)
"bo" = (/obj/structure/safe,/obj/item/weapon/moneybag/vault,/obj/item/weapon/vampiric,/obj/item/weapon/virusdish/random,/obj/item/weapon/archaeological_find,/turf/simulated/floor/reinforced,/area/mine/unexplored)
"bp" = (/obj/structure/reagent_dispensers/water_cooler,/turf/simulated/floor,/area/mine/unexplored)
"bq" = (/obj/effect/floor_decal/corner/paleblue/diagonal,/turf/simulated/floor/tiled/white,/area/mine/unexplored)
"br" = (/obj/structure/toilet{tag = "icon-toilet00 (EAST)"; icon_state = "toilet00"; dir = 4},/turf/simulated/floor/tiled/dark,/area/mine/unexplored)
"bs" = (/obj/machinery/door/unpowered/simple/wood,/turf/simulated/floor/tiled/dark,/area/mine/unexplored)
"bt" = (/obj/structure/closet/medical_wall{pixel_y = 32},/obj/structure/sink{dir = 4; icon_state = "sink"; pixel_x = 8; tag = "icon-sink (EAST)"},/obj/structure/mirror{pixel_x = 28},/turf/simulated/floor/tiled/dark,/area/mine/unexplored)
"bu" = (/obj/structure/bedsheetbin,/obj/structure/table/standard,/turf/simulated/floor/tiled/dark,/area/mine/unexplored)
"bv" = (/obj/effect/floor_decal/spline/fancy{tag = "icon-spline_fancy (EAST)"; icon_state = "spline_fancy"; dir = 4},/turf/simulated/floor/tiled/dark,/area/mine/unexplored)
"bw" = (/obj/item/weapon/stool,/obj/machinery/light{tag = "icon-tube1 (NORTH)"; icon_state = "tube1"; dir = 1},/obj/effect/floor_decal/spline/fancy{tag = "icon-spline_fancy (NORTH)"; icon_state = "spline_fancy"; dir = 1},/obj/effect/floor_decal/corner/paleblue/diagonal,/turf/simulated/floor/tiled/white,/area/mine/unexplored)
"bx" = (/obj/structure/table/standard,/obj/item/weapon/reagent_containers/food/drinks/bottle/small/ale,/obj/item/trash/bowl,/obj/effect/floor_decal/spline/fancy{tag = "icon-spline_fancy (NORTH)"; icon_state = "spline_fancy"; dir = 1},/obj/effect/floor_decal/spline/fancy{tag = "icon-spline_fancy (WEST)"; icon_state = "spline_fancy"; dir = 8},/turf/simulated/floor/tiled/freezer,/area/mine/unexplored)
"by" = (/obj/structure/table/standard,/obj/item/weapon/tray,/obj/effect/floor_decal/spline/fancy{tag = "icon-spline_fancy (NORTH)"; icon_state = "spline_fancy"; dir = 1},/turf/simulated/floor/tiled/freezer,/area/mine/unexplored)
"bz" = (/obj/effect/floor_decal/spline/fancy{tag = "icon-spline_fancy (NORTH)"; icon_state = "spline_fancy"; dir = 1},/turf/simulated/floor/tiled/freezer,/area/mine/unexplored)
"bA" = (/obj/structure/kitchenspike,/obj/effect/floor_decal/spline/fancy{tag = "icon-spline_fancy (NORTH)"; icon_state = "spline_fancy"; dir = 1},/turf/simulated/floor/tiled/freezer,/area/mine/unexplored)
"bB" = (/obj/machinery/light{tag = "icon-tube1 (EAST)"; icon_state = "tube1"; dir = 4},/turf/simulated/floor/tiled/dark,/area/mine/unexplored)
"bC" = (/obj/machinery/light{tag = "icon-tube1 (WEST)"; icon_state = "tube1"; dir = 8},/turf/simulated/floor/tiled/dark,/area/mine/unexplored)
"bD" = (/obj/item/weapon/stool,/obj/item/weapon/cigbutt,/obj/effect/floor_decal/corner/paleblue/diagonal,/turf/simulated/floor/tiled/white,/area/mine/unexplored)
"bE" = (/obj/structure/table/standard,/obj/item/weapon/reagent_containers/food/drinks/bottle/vodka,/obj/effect/floor_decal/spline/fancy{tag = "icon-spline_fancy (NORTHWEST)"; icon_state = "spline_fancy"; dir = 9},/turf/simulated/floor/tiled/freezer,/area/mine/unexplored)
"bF" = (/turf/simulated/floor/tiled/freezer,/area/mine/unexplored)
"bG" = (/obj/effect/decal/cleanable/flour,/turf/simulated/floor/tiled/freezer,/area/mine/unexplored)
"bH" = (/obj/machinery/light{tag = "icon-tube1 (EAST)"; icon_state = "tube1"; dir = 4},/obj/machinery/cooker/grill,/obj/effect/decal/cleanable/ash,/turf/simulated/floor/tiled/freezer,/area/mine/unexplored)
"bI" = (/obj/machinery/shower{tag = "icon-shower (EAST)"; icon_state = "shower"; dir = 4},/obj/item/weapon/soap/syndie,/turf/simulated/floor/tiled/dark,/area/mine/unexplored)
"bJ" = (/obj/structure/curtain/open/shower,/turf/simulated/floor/tiled/dark,/area/mine/unexplored)
"bK" = (/obj/item/weapon/stool,/obj/effect/floor_decal/corner/paleblue/diagonal,/mob/living/simple_animal/hostile/urist/skrellterrorist,/turf/simulated/floor/tiled/white,/area/mine/unexplored)
"bL" = (/obj/structure/table/standard,/obj/item/weapon/reagent_containers/food/snacks/ricepudding,/obj/item/weapon/material/kitchen/utensil/spoon/plastic,/obj/effect/floor_decal/spline/fancy{tag = "icon-spline_fancy (NORTHWEST)"; icon_state = "spline_fancy"; dir = 9},/turf/simulated/floor/tiled/freezer,/area/mine/unexplored)
"bM" = (/obj/structure/closet/secure_closet/freezer/fridge,/turf/simulated/floor/tiled/freezer,/area/mine/unexplored)
"bN" = (/obj/item/weapon/stool,/obj/effect/floor_decal/corner/paleblue/diagonal,/turf/simulated/floor/tiled/white,/area/mine/unexplored)
"bO" = (/obj/structure/table/standard,/obj/item/weapon/reagent_containers/food/snacks/fries,/obj/item/weapon/reagent_containers/food/condiment/saltshaker,/obj/effect/floor_decal/spline/fancy{tag = "icon-spline_fancy (WEST)"; icon_state = "spline_fancy"; dir = 8},/turf/simulated/floor/tiled/freezer,/area/mine/unexplored)
"bP" = (/mob/living/simple_animal/hostile/urist/skrellterrorist,/turf/simulated/floor/tiled/freezer,/area/mine/unexplored)
"bQ" = (/obj/effect/decal/cleanable/fruit_smudge,/turf/simulated/floor/tiled/freezer,/area/mine/unexplored)
"bR" = (/obj/structure/table/standard,/obj/machinery/microwave,/turf/simulated/floor/tiled/freezer,/area/mine/unexplored)
"bS" = (/obj/structure/toilet{tag = "icon-toilet00 (EAST)"; icon_state = "toilet00"; dir = 4},/obj/effect/decal/cleanable/vomit,/mob/living/simple_animal/hostile/urist/skrellterrorist,/turf/simulated/floor/tiled/dark,/area/mine/unexplored)
"bT" = (/obj/structure/sink{dir = 4; icon_state = "sink"; pixel_x = 8; tag = "icon-sink (EAST)"},/obj/structure/mirror{pixel_x = 28},/turf/simulated/floor/tiled/dark,/area/mine/unexplored)
"bU" = (/obj/machinery/space_heater,/turf/simulated/floor/tiled/dark,/area/mine/unexplored)
"bV" = (/obj/structure/table/standard,/obj/item/weapon/reagent_containers/food/snacks/jelliedtoast,/obj/effect/floor_decal/spline/fancy{tag = "icon-spline_fancy (WEST)"; icon_state = "spline_fancy"; dir = 8},/turf/simulated/floor/tiled/freezer,/area/mine/unexplored)
"bW" = (/obj/structure/table/standard,/obj/item/weapon/reagent_containers/food/snacks/liquidfood,/obj/item/weapon/reagent_containers/food/snacks/liquidfood,/obj/item/weapon/reagent_containers/food/snacks/liquidfood,/obj/item/weapon/material/kitchen/rollingpin,/obj/item/weapon/material/knife,/obj/effect/decal/cleanable/flour,/turf/simulated/floor/tiled/freezer,/area/mine/unexplored)
"bX" = (/obj/machinery/light{tag = "icon-tube1 (WEST)"; icon_state = "tube1"; dir = 8},/obj/effect/floor_decal/corner/paleblue/diagonal,/turf/simulated/floor/tiled/white,/area/mine/unexplored)
"bY" = (/obj/structure/table/standard,/obj/item/weapon/reagent_containers/food/snacks/vegetablesoup,/obj/item/weapon/material/kitchen/utensil/spoon/plastic,/obj/effect/floor_decal/spline/fancy{tag = "icon-spline_fancy (SOUTHWEST)"; icon_state = "spline_fancy"; dir = 10},/turf/simulated/floor/tiled/freezer,/area/mine/unexplored)
"bZ" = (/obj/machinery/cooker/fryer,/obj/machinery/light{tag = "icon-tube1 (EAST)"; icon_state = "tube1"; dir = 4},/turf/simulated/floor/tiled/freezer,/area/mine/unexplored)
"ca" = (/turf/simulated/wall,/turf/simulated/floor/airless/uristturf,/area/mine/unexplored)
"cb" = (/turf/simulated/floor/asteroid,/turf/simulated/floor/airless/uristturf,/area/mine/unexplored)
"cc" = (/turf/simulated/floor/asteroid,/obj/machinery/light/spot{tag = "icon-tube1 (EAST)"; icon_state = "tube1"; dir = 4},/obj/machinery/floodlight,/turf/simulated/floor/airless/uristturf,/area/mine/unexplored)
"cd" = (/obj/effect/decal/cleanable/dirt,/obj/structure/table/rack,/turf/simulated/floor/tiled/dark,/area/mine/unexplored)
"ce" = (/obj/machinery/light{tag = "icon-tube1 (NORTH)"; icon_state = "tube1"; dir = 1},/obj/structure/table/rack,/turf/simulated/floor/tiled/dark,/area/mine/unexplored)
"cf" = (/obj/structure/dispenser,/turf/simulated/floor/tiled/dark,/area/mine/unexplored)
"cg" = (/obj/item/weapon/cigbutt,/obj/effect/floor_decal/corner/paleblue/diagonal,/turf/simulated/floor/tiled/white,/area/mine/unexplored)
"ch" = (/obj/structure/table/standard,/obj/item/trash/snack_bowl,/obj/effect/floor_decal/spline/fancy{tag = "icon-spline_fancy (SOUTHWEST)"; icon_state = "spline_fancy"; dir = 10},/turf/simulated/floor/tiled/freezer,/area/mine/unexplored)
"ci" = (/obj/structure/closet/secure_closet/freezer/kitchen/mining,/turf/simulated/floor/tiled/freezer,/area/mine/unexplored)
"cj" = (/turf/simulated/floor/asteroid,/obj/item/trash/liquidfood,/turf/simulated/floor/airless/uristturf,/area/mine/unexplored)
"ck" = (/mob/living/simple_animal/hostile/urist/skrellterrorist,/turf/simulated/floor/tiled/dark,/area/mine/unexplored)
"cl" = (/obj/structure/table/standard,/obj/item/weapon/reagent_containers/food/snacks/fries,/obj/effect/floor_decal/spline/fancy{tag = "icon-spline_fancy (SOUTHWEST)"; icon_state = "spline_fancy"; dir = 10},/turf/simulated/floor/tiled/freezer,/area/mine/unexplored)
"cm" = (/obj/structure/table/standard,/obj/item/weapon/reagent_containers/food/drinks/bottle/rum,/obj/effect/floor_decal/spline/fancy,/turf/simulated/floor/tiled/freezer,/area/mine/unexplored)
"cn" = (/obj/effect/floor_decal/spline/fancy,/turf/simulated/floor/tiled/freezer,/area/mine/unexplored)
"co" = (/obj/structure/extinguisher_cabinet{pixel_x = 32},/obj/effect/floor_decal/spline/fancy,/turf/simulated/floor/tiled/freezer,/area/mine/unexplored)
"cp" = (/turf/simulated/floor/asteroid,/obj/machinery/light/spot{tag = "icon-tube1 (EAST)"; icon_state = "tube1"; dir = 4},/obj/item/weapon/cigbutt,/obj/item/weapon/cigbutt,/turf/simulated/floor/airless/uristturf,/area/mine/unexplored)
"cq" = (/obj/structure/table/rack,/turf/simulated/floor/tiled/dark,/area/mine/unexplored)
"cr" = (/obj/structure/coatrack,/obj/effect/floor_decal/corner/paleblue/diagonal,/turf/simulated/floor/tiled/white,/area/mine/unexplored)
"cs" = (/obj/machinery/media/jukebox,/obj/effect/floor_decal/corner/paleblue/diagonal,/turf/simulated/floor/tiled/white,/area/mine/unexplored)
"ct" = (/turf/simulated/floor/asteroid,/mob/living/simple_animal/hostile/syndicate/ranged/space{faction = "skrellt"; name = "Skrellian terrorist"},/turf/simulated/floor/airless/uristturf,/area/mine/unexplored)
"cu" = (/turf/simulated/floor/asteroid,/obj/item/weapon/cigbutt,/turf/simulated/floor/airless/uristturf,/area/mine/unexplored)
"cv" = (/obj/machinery/space_heater,/obj/effect/decal/cleanable/spiderling_remains,/obj/effect/floor_decal/corner/paleblue/diagonal,/turf/simulated/floor/tiled/white,/area/mine/unexplored)
"cw" = (/obj/machinery/smartfridge/drinks,/obj/effect/floor_decal/corner/paleblue/diagonal,/turf/simulated/floor/tiled/white,/area/mine/unexplored)
"cx" = (/turf/simulated/wall/r_wall,/obj/item/ammo_casing/a10mm,/obj/item/ammo_casing/a10mm,/obj/item/ammo_casing/a10mm,/obj/item/ammo_casing/a10mm,/turf/simulated/floor/airless/uristturf,/area/mine/unexplored)
"cy" = (/turf/simulated/floor/asteroid,/obj/item/ammo_casing/a10mm,/obj/item/ammo_casing/a10mm,/obj/item/ammo_casing/a10mm,/obj/item/ammo_casing/a10mm,/obj/item/ammo_casing/a10mm,/mob/living/simple_animal/hostile/syndicate/ranged/space{faction = "skrellt"; name = "Skrellian terrorist"},/turf/simulated/floor/airless/uristturf,/area/mine/unexplored)
"cz" = (/turf/simulated/wall/r_wall,/obj/item/target,/turf/simulated/floor/airless/uristturf,/area/mine/unexplored)

(1,1,1) = {"
aaabacabacabacabacababababababadabababab
abaeafagafahafaiajaeaeakalamabananananab
acaoapapapapapapapaqaearasatabauauavanab
abawapaxayazaAaBapaCaeaDaEaFababababaGab
acafapaHaIaJaKaLapapaMapapapabaNaOaPaQab
abaRapaSaTaUaVaWapapaXapapapadaQaQaQaYab
acafapapapapapapapaZaebabbbbadaQbcbcaQab
abaebdbebdbfbdbgbhaeaebibjbkabblbmbnboab
abaeaeaeaeaeaeaeaeaebpbqbqbqabababababab
abbrbsanbtaebuanbvbqbqbqbqbqbwbxbybzbAab
abaeaeanbBaebCanbvbqbqbqbqbDbEbFbFbGbHab
abbIbJananbsananbvbqbqbqbKbLbFbFbFbFbMab
abaeaeanbBaebCanbvbqbqbqbNbObFbPbFbQbRab
abbSbsanbTaebUanbvbqbqbqbNbVbFbFbFbFbWab
abababababababababbXbqbqbKbYbFbFbFbFbZab
cacbccabcdcececfabcgbqbqbqbNchbFbFbFciab
cacjcbadananckanaGbqbqbqbqbqbNclcmcncoab
cacbcpabcqcqcqcqabcrbqbqbqbqbqbNbNbqcsab
cactcuababababababababababcvbqbqbqbqcwab
aaaaaacxcycbcbcbaaaaaaczabababababababab
"}
