"aa" = (/turf/simulated/wall/r_wall,/turf/simulated/floor/airless/uristturf,/area/mine/unexplored)
"ab" = (/turf/simulated/wall/r_wall,/area/mine/unexplored)
"ac" = (/obj/structure/window/reinforced,/obj/structure/window/reinforced{dir = 8},/obj/structure/window/reinforced{dir = 4},/obj/structure/window/reinforced{tag = "icon-rwindow (NORTH)"; icon_state = "rwindow"; dir = 1},/obj/structure/grille,/turf/simulated/floor,/area/mine/unexplored)
"ad" = (/obj/machinery/door/airlock/highsecurity,/turf/simulated/floor,/area/mine/unexplored)
"ae" = (/turf/simulated/wall,/area/mine/unexplored)
"af" = (/obj/structure/bed/alien,/obj/item/weapon/bedsheet/syndie,/turf/simulated/floor/carpet{tag = "icon-carpet6-2 (NORTH)"; icon_state = "carpet6-2"; dir = 1},/area/mine/unexplored)
"ag" = (/obj/structure/closet,/obj/machinery/light/small/built{tag = "icon-bulb1 (NORTH)"; icon_state = "bulb1"; dir = 1},/obj/item/clothing/accessory/storage/knifeharness,/obj/item/device/measuring_tape,/turf/simulated/floor/carpet{tag = "icon-carpet14-10 (NORTH)"; icon_state = "carpet14-10"; dir = 1},/area/mine/unexplored)
"ah" = (/obj/structure/bed/alien,/obj/item/weapon/bedsheet/syndie,/turf/simulated/floor/carpet{tag = "icon-carpet14-10 (NORTH)"; icon_state = "carpet14-10"; dir = 1},/area/mine/unexplored)
"ai" = (/obj/structure/closet,/obj/machinery/light/small/built{tag = "icon-bulb1 (NORTH)"; icon_state = "bulb1"; dir = 1},/obj/item/weapon/storage/briefcase,/turf/simulated/floor/carpet{tag = "icon-carpet14-10 (NORTH)"; icon_state = "carpet14-10"; dir = 1},/area/mine/unexplored)
"aj" = (/obj/structure/closet,/obj/machinery/light/small/built{tag = "icon-bulb1 (NORTH)"; icon_state = "bulb1"; dir = 1},/obj/random/contraband,/obj/random/contraband,/turf/simulated/floor/carpet{tag = "icon-carpet14-10 (NORTH)"; icon_state = "carpet14-10"; dir = 1},/area/mine/unexplored)
"ak" = (/obj/structure/bed/alien,/obj/item/weapon/bedsheet/syndie,/obj/random/plushie,/turf/simulated/floor/carpet{tag = "icon-carpet10-8 (NORTH)"; icon_state = "carpet10-8"; dir = 1},/area/mine/unexplored)
"al" = (/obj/structure/bookcase/manuals/medical,/turf/simulated/floor/wood{tag = "icon-wood-broken"; icon_state = "wood-broken"},/area/mine/unexplored)
"am" = (/obj/machinery/light/small/built{tag = "icon-bulb1 (NORTH)"; icon_state = "bulb1"; dir = 1},/obj/structure/bookcase,/turf/simulated/floor/wood,/area/mine/unexplored)
"an" = (/obj/structure/bookcase,/turf/simulated/floor/wood{tag = "icon-wood-broken5"; icon_state = "wood-broken5"},/area/mine/unexplored)
"ao" = (/turf/simulated/floor{tag = "icon-bcircuitoff"; icon_state = "bcircuitoff"},/area/mine/unexplored)
"ap" = (/obj/structure/bed/alien,/obj/item/weapon/bedsheet/syndie,/mob/living/simple_animal/hostile/urist/skrellterrorist,/turf/simulated/floor/wood,/area/mine/unexplored)
"aq" = (/turf/simulated/floor/carpet{tag = "icon-carpet7-3 (NORTH)"; icon_state = "carpet7-3"; dir = 1},/area/mine/unexplored)
"ar" = (/turf/simulated/floor/carpet{tag = "icon-carpet0-0 (NORTH)"; icon_state = "carpet0-0"; dir = 1},/area/mine/unexplored)
"as" = (/turf/simulated/floor/carpet{tag = "icon-carpet12-0 (NORTH)"; icon_state = "carpet12-0"; dir = 1},/area/mine/unexplored)
"at" = (/turf/simulated/floor/carpet{tag = "icon-carpet11-12 (NORTH)"; icon_state = "carpet11-12"; dir = 1},/area/mine/unexplored)
"au" = (/obj/structure/dresser,/obj/effect/decal/cleanable/cobweb2,/turf/simulated/floor{tag = "icon-wood-broken7"; icon_state = "wood-broken7"},/area/mine/unexplored)
"av" = (/obj/structure/bed/chair/comfy/brown{tag = "icon-comfychair_preview (EAST)"; icon_state = "comfychair_preview"; dir = 4},/obj/effect/decal/cleanable/dirt,/mob/living/simple_animal/hostile/urist/skrellterrorist,/turf/simulated/floor/wood,/area/mine/unexplored)
"aw" = (/obj/structure/table/woodentable,/obj/item/device/flashlight/lamp,/turf/simulated/floor/wood,/area/mine/unexplored)
"ax" = (/obj/structure/bed/chair/comfy/brown{tag = "icon-comfychair_preview (WEST)"; icon_state = "comfychair_preview"; dir = 8},/mob/living/simple_animal/hostile/urist/skrellterrorist,/turf/simulated/floor/wood{tag = "icon-wood-broken4"; icon_state = "wood-broken4"},/area/mine/unexplored)
"ay" = (/obj/structure/closet/emsuits,/obj/structure/closet/walllocker/emerglocker{pixel_y = -32},/turf/simulated/floor{tag = "icon-bcircuitoff"; icon_state = "bcircuitoff"},/area/mine/unexplored)
"az" = (/obj/structure/dispenser,/turf/simulated/floor{tag = "icon-bcircuitoff"; icon_state = "bcircuitoff"},/area/mine/unexplored)
"aA" = (/obj/structure/closet,/obj/random/contraband,/obj/item/weapon/cane,/turf/simulated/floor{tag = "icon-wood-broken6"; icon_state = "wood-broken6"},/area/mine/unexplored)
"aB" = (/obj/structure/bed/chair/wood{tag = "icon-wooden_chair (EAST)"; icon_state = "wooden_chair"; dir = 4},/turf/simulated/floor/carpet{tag = "icon-carpet3-0 (NORTH)"; icon_state = "carpet3-0"; dir = 1},/area/mine/unexplored)
"aC" = (/obj/structure/table/woodentable,/turf/simulated/floor/carpet{tag = "icon-carpet6-0 (NORTH)"; icon_state = "carpet6-0"; dir = 1},/area/mine/unexplored)
"aD" = (/obj/structure/table/woodentable,/obj/random/contraband,/turf/simulated/floor/carpet{tag = "icon-carpetside (NORTH)"; icon_state = "carpetside"; dir = 1},/area/mine/unexplored)
"aE" = (/obj/structure/table/woodentable,/obj/item/weapon/dice,/obj/item/weapon/folder,/turf/simulated/floor/carpet{tag = "icon-carpet10-0 (NORTH)"; icon_state = "carpet10-0"; dir = 1},/area/mine/unexplored)
"aF" = (/obj/structure/bed/chair/wood{tag = "icon-wooden_chair (WEST)"; icon_state = "wooden_chair"; dir = 8},/turf/simulated/floor/carpet{tag = "icon-carpet3-0 (NORTH)"; icon_state = "carpet3-0"; dir = 1},/area/mine/unexplored)
"aG" = (/obj/machinery/space_heater,/obj/structure/extinguisher_cabinet{pixel_x = 32},/turf/simulated/floor/wood,/area/mine/unexplored)
"aH" = (/turf/simulated/floor/wood{tag = "icon-wood-broken2"; icon_state = "wood-broken2"},/obj/structure/bed/chair/comfy/brown{tag = "icon-comfychair_preview (EAST)"; icon_state = "comfychair_preview"; dir = 4},/turf/simulated/floor{tag = "icon-siding2"; icon_state = "siding2"},/area/mine/unexplored)
"aI" = (/turf/simulated/floor/wood,/obj/structure/table/woodentable,/obj/item/weapon/newspaper,/turf/simulated/floor{tag = "icon-siding2"; icon_state = "siding2"},/area/mine/unexplored)
"aJ" = (/turf/simulated/floor/wood,/obj/structure/bed/chair/comfy/brown{tag = "icon-comfychair_preview (WEST)"; icon_state = "comfychair_preview"; dir = 8},/turf/simulated/floor{tag = "icon-siding2"; icon_state = "siding2"},/area/mine/unexplored)
"aK" = (/obj/structure/bed/alien,/obj/item/weapon/bedsheet/syndie,/turf/simulated/floor/wood,/area/mine/unexplored)
"aL" = (/obj/structure/bed/chair/wood{tag = "icon-wooden_chair (EAST)"; icon_state = "wooden_chair"; dir = 4},/obj/item/weapon/cigbutt/cigarbutt,/turf/simulated/floor/carpet{tag = "icon-carpet3-0 (NORTH)"; icon_state = "carpet3-0"; dir = 1},/area/mine/unexplored)
"aM" = (/obj/structure/table/woodentable,/obj/item/device/radio/off,/turf/simulated/floor/carpet{tag = "icon-carpet7-3 (NORTH)"; icon_state = "carpet7-3"; dir = 1},/area/mine/unexplored)
"aN" = (/obj/structure/cult/pylon,/obj/item/weapon/ectoplasm,/turf/simulated/floor/carpet{tag = "icon-carpetsymbol (NORTH)"; icon_state = "carpetsymbol"; dir = 1},/area/mine/unexplored)
"aO" = (/obj/structure/table/woodentable,/obj/item/device/flashlight/lamp,/turf/simulated/floor/carpet{tag = "icon-carpet11-12 (NORTH)"; icon_state = "carpet11-12"; dir = 1},/area/mine/unexplored)
"aP" = (/turf/simulated/floor/wood,/area/mine/unexplored)
"aQ" = (/obj/structure/simple_door/wood,/turf/simulated/floor{tag = "icon-wood-broken5"; icon_state = "wood-broken5"},/area/mine/unexplored)
"aR" = (/turf/simulated/floor{tag = "icon-dark"; icon_state = "dark"},/area/mine/unexplored)
"aS" = (/obj/structure/closet/secure_closet/guncabinet,/obj/random/projectile,/obj/random/projectile,/obj/random/projectile,/obj/item/weapon/gun/projectile/automatic/c20r/sc_c20r,/turf/simulated/floor/engine,/area/mine/unexplored)
"aT" = (/obj/structure/closet/secure_closet/guncabinet,/obj/random/projectile,/obj/random/handgun,/turf/simulated/floor/engine,/area/mine/unexplored)
"aU" = (/obj/structure/closet/secure_closet/guncabinet,/obj/random/projectile,/turf/simulated/floor/engine,/area/mine/unexplored)
"aV" = (/turf/simulated/floor/engine,/area/mine/unexplored)
"aW" = (/obj/structure/closet,/obj/random/action_figure,/obj/random/bomb_supply,/turf/simulated/floor{tag = "icon-wood-broken7"; icon_state = "wood-broken7"},/area/mine/unexplored)
"aX" = (/obj/structure/table/woodentable,/obj/item/weapon/reagent_containers/food/snacks/skrellsnacks,/turf/simulated/floor/carpet{tag = "icon-carpet5-0 (NORTH)"; icon_state = "carpet5-0"; dir = 1},/area/mine/unexplored)
"aY" = (/obj/structure/table/woodentable,/obj/item/weapon/gag/BANG{desc = "When you absolutely, positively need a 10mm hole in the other guy. Uses .357 ammo."; name = "mateba"},/turf/simulated/floor/carpet{tag = "icon-carpet13-5 (NORTH)"; icon_state = "carpet13-5"; dir = 1},/area/mine/unexplored)
"aZ" = (/obj/structure/table/woodentable,/obj/item/weapon/reagent_containers/food/drinks/coffee,/turf/simulated/floor/carpet{tag = "icon-carpet9-0 (NORTH)"; icon_state = "carpet9-0"; dir = 1},/area/mine/unexplored)
"ba" = (/obj/structure/simple_door/wood,/turf/simulated/floor/wood,/area/mine/unexplored)
"bb" = (/obj/structure/extinguisher_cabinet{pixel_x = 32},/turf/simulated/floor/engine,/area/mine/unexplored)
"bc" = (/obj/structure/closet/wardrobe/pjs,/turf/simulated/floor{tag = "icon-wood-broken7"; icon_state = "wood-broken7"},/area/mine/unexplored)
"bd" = (/turf/simulated/floor{tag = "icon-dark"; icon_state = "dark"},/obj/structure/noticeboard{pixel_x = -32},/turf/simulated/floor{tag = "icon-siding2"; icon_state = "siding2"},/area/mine/unexplored)
"be" = (/turf/simulated/floor{tag = "icon-dark"; icon_state = "dark"},/turf/simulated/floor{tag = "icon-siding2"; icon_state = "siding2"},/area/mine/unexplored)
"bf" = (/mob/living/simple_animal/hostile/urist/skrellterrorist,/turf/simulated/floor/engine,/area/mine/unexplored)
"bg" = (/obj/structure/bed/alien,/obj/item/weapon/bedsheet/syndie,/obj/structure/closet/walllocker/emerglocker{pixel_y = -32},/turf/simulated/floor/carpet{tag = "icon-carpet5-1 (NORTH)"; icon_state = "carpet5-1"; dir = 1},/area/mine/unexplored)
"bh" = (/obj/structure/closet,/obj/machinery/light/small/built,/obj/random/toolbox,/turf/simulated/floor/carpet{tag = "icon-carpet13-5 (NORTH)"; icon_state = "carpet13-5"; dir = 1},/area/mine/unexplored)
"bi" = (/obj/structure/bed/alien,/obj/item/weapon/bedsheet/syndie,/obj/structure/closet/walllocker/emerglocker{pixel_y = -32},/turf/simulated/floor/carpet{tag = "icon-carpet13-5 (NORTH)"; icon_state = "carpet13-5"; dir = 1},/area/mine/unexplored)
"bj" = (/obj/structure/closet,/obj/machinery/light/small/built,/obj/item/weapon/gun/projectile/automatic/c20r/sc_c20r,/turf/simulated/floor/carpet{tag = "icon-carpet13-5 (NORTH)"; icon_state = "carpet13-5"; dir = 1},/area/mine/unexplored)
"bk" = (/obj/structure/closet,/obj/machinery/light/small/built,/obj/item/clothing/mask/balaclava,/turf/simulated/floor/carpet{tag = "icon-carpet13-5 (NORTH)"; icon_state = "carpet13-5"; dir = 1},/area/mine/unexplored)
"bl" = (/obj/structure/bed/alien,/obj/item/weapon/bedsheet/syndie,/obj/structure/closet/walllocker/emerglocker{pixel_y = -32},/mob/living/simple_animal/hostile/urist/skrellterrorist,/turf/simulated/floor/carpet{tag = "icon-carpet9-4 (NORTH)"; icon_state = "carpet9-4"; dir = 1},/area/mine/unexplored)
"bm" = (/obj/structure/window/reinforced{tag = "icon-rwindow (NORTH)"; icon_state = "rwindow"; dir = 1},/turf/simulated/floor,/area/mine/unexplored)
"bn" = (/turf/simulated/floor{tag = "icon-stage_stairs"; icon_state = "stage_stairs"},/area/mine/unexplored)
"bo" = (/turf/simulated/floor{tag = "icon-bar"; icon_state = "bar"},/obj/structure/sign/securearea{pixel_x = 28},/obj/structure/window/reinforced{tag = "icon-rwindow (NORTH)"; icon_state = "rwindow"; dir = 1},/turf/simulated/floor{tag = "icon-wood_siding8"; icon_state = "wood_siding8"},/area/mine/unexplored)
"bp" = (/obj/structure/closet/syndicate/suit,/turf/simulated/floor/engine,/area/mine/unexplored)
"bq" = (/obj/structure/closet/syndicate,/obj/random/firstaid,/obj/item/weapon/reagent_containers/glass/beaker/vial/random/toxin,/turf/simulated/floor/engine,/area/mine/unexplored)
"br" = (/obj/structure/closet/syndicate,/obj/random/ammo,/obj/random/ammo,/obj/item/weapon/grenade/chem_grenade/teargas,/turf/simulated/floor/engine,/area/mine/unexplored)
"bs" = (/obj/structure/safe,/obj/item/weapon/moneybag/vault,/obj/item/weapon/vampiric,/obj/effect/decal/remains/mouse,/obj/item/weapon/virusdish/random,/obj/item/weapon/archaeological_find,/turf/simulated/floor/engine,/area/mine/unexplored)
"bt" = (/obj/structure/reagent_dispensers/water_cooler,/turf/simulated/floor,/area/mine/unexplored)
"bu" = (/turf/simulated/floor,/area/mine/unexplored)
"bv" = (/turf/simulated/floor{tag = "icon-bar"; icon_state = "bar"},/turf/simulated/floor{tag = "icon-wood_siding8"; icon_state = "wood_siding8"},/turf/simulated/floor{tag = "icon-wood_siding9"; icon_state = "wood_siding9"},/area/mine/unexplored)
"bw" = (/turf/simulated/floor{tag = "icon-bar"; icon_state = "bar"},/area/mine/unexplored)
"bx" = (/obj/structure/toilet{tag = "icon-toilet00 (EAST)"; icon_state = "toilet00"; dir = 4},/turf/simulated/floor{tag = "icon-barber"; icon_state = "barber"},/area/mine/unexplored)
"by" = (/obj/structure/simple_door/wood,/turf/simulated/floor{tag = "icon-barber"; icon_state = "barber"},/area/mine/unexplored)
"bz" = (/turf/simulated/floor{tag = "icon-barber"; icon_state = "barber"},/area/mine/unexplored)
"bA" = (/obj/structure/closet/medical_wall{pixel_y = 32},/obj/structure/sink{dir = 4; icon_state = "sink"; pixel_x = 8; tag = "icon-sink (EAST)"},/obj/structure/mirror{pixel_x = 28},/turf/simulated/floor{tag = "icon-barber"; icon_state = "barber"},/area/mine/unexplored)
"bB" = (/obj/structure/bedsheetbin,/obj/structure/table/standard,/turf/simulated/floor,/area/mine/unexplored)
"bC" = (/turf/simulated/floor{tag = "icon-bar"; icon_state = "bar"},/turf/simulated/floor{tag = "icon-wood_siding8"; icon_state = "wood_siding8"},/area/mine/unexplored)
"bD" = (/obj/item/weapon/stool,/obj/machinery/light/built{tag = "icon-tube1 (NORTH)"; icon_state = "tube1"; dir = 1},/turf/simulated/floor{tag = "icon-bar"; icon_state = "bar"},/area/mine/unexplored)
"bE" = (/turf/simulated/floor{tag = "icon-cafeteria"; icon_state = "cafeteria"},/turf/simulated/floor{tag = "icon-siding1"; icon_state = "siding1"},/obj/structure/table/standard,/obj/item/weapon/reagent_containers/food/drinks/cans/ale,/obj/item/trash/bowl,/turf/simulated/floor{tag = "icon-siding9"; icon_state = "siding9"},/area/mine/unexplored)
"bF" = (/turf/simulated/floor{tag = "icon-cafeteria"; icon_state = "cafeteria"},/obj/structure/table/standard,/obj/item/weapon/tray,/turf/simulated/floor{tag = "icon-siding1"; icon_state = "siding1"},/area/mine/unexplored)
"bG" = (/turf/simulated/floor{tag = "icon-cafeteria"; icon_state = "cafeteria"},/turf/simulated/floor{tag = "icon-siding1"; icon_state = "siding1"},/area/mine/unexplored)
"bH" = (/turf/simulated/floor{tag = "icon-cafeteria"; icon_state = "cafeteria"},/obj/structure/kitchenspike,/turf/simulated/floor{tag = "icon-siding1"; icon_state = "siding1"},/area/mine/unexplored)
"bI" = (/turf/simulated/floor{tag = "icon-bcarpet01"; icon_state = "bcarpet01"},/area/mine/unexplored)
"bJ" = (/obj/machinery/light/built{tag = "icon-tube1 (EAST)"; icon_state = "tube1"; dir = 4},/turf/simulated/floor{tag = "icon-bcarpet03"; icon_state = "bcarpet03"},/area/mine/unexplored)
"bK" = (/obj/machinery/light/built{tag = "icon-tube1 (WEST)"; icon_state = "tube1"; dir = 8},/turf/simulated/floor,/area/mine/unexplored)
"bL" = (/obj/item/weapon/stool,/obj/item/weapon/cigbutt,/turf/simulated/floor{tag = "icon-bar"; icon_state = "bar"},/area/mine/unexplored)
"bM" = (/turf/simulated/floor{tag = "icon-cafeteria"; icon_state = "cafeteria"},/obj/structure/table/standard,/obj/item/weapon/reagent_containers/food/drinks/bottle/vodka,/turf/simulated/floor{tag = "icon-siding9"; icon_state = "siding9"},/area/mine/unexplored)
"bN" = (/turf/simulated/floor{tag = "icon-cafeteria"; icon_state = "cafeteria"},/area/mine/unexplored)
"bO" = (/obj/effect/decal/cleanable/flour,/turf/simulated/floor{tag = "icon-cafeteria"; icon_state = "cafeteria"},/area/mine/unexplored)
"bP" = (/obj/machinery/light/built{tag = "icon-tube1 (EAST)"; icon_state = "tube1"; dir = 4},/obj/machinery/foodgrill,/obj/effect/decal/cleanable/ash,/turf/simulated/floor{tag = "icon-cafeteria"; icon_state = "cafeteria"},/area/mine/unexplored)
"bQ" = (/obj/machinery/shower{tag = "icon-shower (EAST)"; icon_state = "shower"; dir = 4},/obj/item/weapon/soap/syndie,/turf/simulated/floor{tag = "icon-barber"; icon_state = "barber"},/area/mine/unexplored)
"bR" = (/obj/structure/curtain/open/shower,/turf/simulated/floor{tag = "icon-barber"; icon_state = "barber"},/area/mine/unexplored)
"bS" = (/turf/simulated/floor{tag = "icon-bcarpet04"; icon_state = "bcarpet04"},/area/mine/unexplored)
"bT" = (/turf/simulated/floor{tag = "icon-bcarpet06"; icon_state = "bcarpet06"},/area/mine/unexplored)
"bU" = (/turf/simulated/floor{tag = "icon-bar"; icon_state = "bar"},/obj/item/weapon/stool,/mob/living/simple_animal/hostile/urist/skrellterrorist,/turf/simulated/floor{tag = "icon-wood_siding8"; icon_state = "wood_siding8"},/area/mine/unexplored)
"bV" = (/turf/simulated/floor{tag = "icon-cafeteria"; icon_state = "cafeteria"},/turf/simulated/floor{tag = "icon-siding8"; icon_state = "siding8"},/obj/structure/table/standard,/obj/item/weapon/reagent_containers/food/snacks/ricepudding,/obj/item/weapon/material/kitchen/utensil/spoon/plastic,/turf/simulated/floor{tag = "icon-siding9"; icon_state = "siding9"},/area/mine/unexplored)
"bW" = (/obj/structure/closet/secure_closet/freezer/fridge,/turf/simulated/floor{tag = "icon-cafeteria"; icon_state = "cafeteria"},/area/mine/unexplored)
"bX" = (/turf/simulated/floor{tag = "icon-bcarpet07"; icon_state = "bcarpet07"},/area/mine/unexplored)
"bY" = (/obj/machinery/light/built{tag = "icon-tube1 (EAST)"; icon_state = "tube1"; dir = 4},/turf/simulated/floor{tag = "icon-bcarpet09"; icon_state = "bcarpet09"},/area/mine/unexplored)
"bZ" = (/turf/simulated/floor{tag = "icon-bar"; icon_state = "bar"},/obj/item/weapon/stool,/turf/simulated/floor{tag = "icon-wood_siding8"; icon_state = "wood_siding8"},/area/mine/unexplored)
"ca" = (/turf/simulated/floor{tag = "icon-cafeteria"; icon_state = "cafeteria"},/obj/structure/table/standard,/obj/item/weapon/reagent_containers/food/snacks/fries,/obj/item/weapon/reagent_containers/food/condiment/saltshaker,/turf/simulated/floor{tag = "icon-siding8"; icon_state = "siding8"},/area/mine/unexplored)
"cb" = (/mob/living/simple_animal/hostile/urist/skrellterrorist,/turf/simulated/floor{tag = "icon-cafeteria"; icon_state = "cafeteria"},/area/mine/unexplored)
"cc" = (/obj/effect/decal/cleanable/fruit_smudge,/turf/simulated/floor{tag = "icon-cafeteria"; icon_state = "cafeteria"},/area/mine/unexplored)
"cd" = (/obj/structure/table/standard,/obj/machinery/microwave,/turf/simulated/floor{tag = "icon-cafeteria"; icon_state = "cafeteria"},/area/mine/unexplored)
"ce" = (/obj/structure/toilet{tag = "icon-toilet00 (EAST)"; icon_state = "toilet00"; dir = 4},/obj/effect/decal/cleanable/vomit,/mob/living/simple_animal/hostile/urist/skrellterrorist,/turf/simulated/floor{tag = "icon-barber"; icon_state = "barber"},/area/mine/unexplored)
"cf" = (/obj/structure/sink{dir = 4; icon_state = "sink"; pixel_x = 8; tag = "icon-sink (EAST)"},/obj/structure/mirror{pixel_x = 28},/turf/simulated/floor{tag = "icon-barber"; icon_state = "barber"},/area/mine/unexplored)
"cg" = (/obj/machinery/space_heater,/turf/simulated/floor,/area/mine/unexplored)
"ch" = (/turf/simulated/floor{tag = "icon-cafeteria"; icon_state = "cafeteria"},/obj/structure/table/standard,/obj/item/weapon/reagent_containers/food/snacks/jelliedtoast,/turf/simulated/floor{tag = "icon-siding8"; icon_state = "siding8"},/area/mine/unexplored)
"ci" = (/obj/structure/table/standard,/obj/item/weapon/reagent_containers/food/snacks/liquidfood,/obj/item/weapon/reagent_containers/food/snacks/liquidfood,/obj/item/weapon/reagent_containers/food/snacks/liquidfood,/obj/item/weapon/material/kitchen/rollingpin,/obj/item/weapon/material/knife,/obj/effect/decal/cleanable/flour,/turf/simulated/floor{tag = "icon-cafeteria"; icon_state = "cafeteria"},/area/mine/unexplored)
"cj" = (/turf/simulated/floor{tag = "icon-cafeteria"; icon_state = "cafeteria"},/turf/simulated/floor{tag = "icon-siding8"; icon_state = "siding8"},/obj/structure/table/standard,/obj/item/weapon/reagent_containers/food/snacks/vegetablesoup,/obj/item/weapon/material/kitchen/utensil/spoon/plastic,/turf/simulated/floor{tag = "icon-siding10"; icon_state = "siding10"},/area/mine/unexplored)
"ck" = (/obj/machinery/deepfryer,/obj/machinery/light/built{tag = "icon-tube1 (EAST)"; icon_state = "tube1"; dir = 4},/turf/simulated/floor{tag = "icon-cafeteria"; icon_state = "cafeteria"},/area/mine/unexplored)
"cl" = (/turf/simulated/wall,/turf/simulated/floor/airless/uristturf,/area/mine/unexplored)
"cm" = (/turf/simulated/floor/plating/airless/asteroid,/turf/simulated/floor/airless/uristturf,/area/mine/unexplored)
"cn" = (/turf/simulated/floor/plating/airless/asteroid,/obj/machinery/light/spot{tag = "icon-tube1 (EAST)"; icon_state = "tube1"; dir = 4},/obj/machinery/floodlight,/turf/simulated/floor/airless/uristturf,/area/mine/unexplored)
"co" = (/obj/effect/decal/cleanable/dirt,/obj/structure/table/rack,/turf/simulated/floor{tag = "icon-blueyellow"; icon_state = "blueyellow"},/area/mine/unexplored)
"cp" = (/obj/machinery/light/built{tag = "icon-tube1 (NORTH)"; icon_state = "tube1"; dir = 1},/obj/structure/table/rack,/turf/simulated/floor{tag = "icon-blueyellow"; icon_state = "blueyellow"},/area/mine/unexplored)
"cq" = (/obj/structure/dispenser,/turf/simulated/floor{tag = "icon-blueyellow"; icon_state = "blueyellow"},/area/mine/unexplored)
"cr" = (/obj/item/weapon/cigbutt,/turf/simulated/floor,/area/mine/unexplored)
"cs" = (/obj/item/weapon/stool,/turf/simulated/floor{tag = "icon-bar"; icon_state = "bar"},/area/mine/unexplored)
"ct" = (/turf/simulated/floor{tag = "icon-cafeteria"; icon_state = "cafeteria"},/obj/structure/table/standard,/obj/item/trash/snack_bowl,/turf/simulated/floor{tag = "icon-siding10"; icon_state = "siding10"},/area/mine/unexplored)
"cu" = (/obj/structure/closet/secure_closet/freezer/kitchen/mining,/turf/simulated/floor{tag = "icon-cafeteria"; icon_state = "cafeteria"},/area/mine/unexplored)
"cv" = (/turf/simulated/floor/plating/airless/asteroid,/obj/item/trash/liquidfood,/turf/simulated/floor/airless/uristturf,/area/mine/unexplored)
"cw" = (/turf/simulated/floor{tag = "icon-blueyellowfull"; icon_state = "blueyellowfull"},/area/mine/unexplored)
"cx" = (/mob/living/simple_animal/hostile/urist/skrellterrorist,/turf/simulated/floor{tag = "icon-blueyellowfull"; icon_state = "blueyellowfull"},/area/mine/unexplored)
"cy" = (/turf/simulated/floor{tag = "icon-cafeteria"; icon_state = "cafeteria"},/turf/simulated/floor{tag = "icon-siding2"; icon_state = "siding2"},/obj/structure/table/standard,/obj/item/weapon/reagent_containers/food/snacks/fries,/turf/simulated/floor{tag = "icon-siding10"; icon_state = "siding10"},/area/mine/unexplored)
"cz" = (/turf/simulated/floor{tag = "icon-cafeteria"; icon_state = "cafeteria"},/obj/structure/table/standard,/obj/item/weapon/reagent_containers/food/drinks/bottle/rum,/turf/simulated/floor{tag = "icon-siding2"; icon_state = "siding2"},/area/mine/unexplored)
"cA" = (/turf/simulated/floor{tag = "icon-cafeteria"; icon_state = "cafeteria"},/turf/simulated/floor{tag = "icon-siding2"; icon_state = "siding2"},/area/mine/unexplored)
"cB" = (/turf/simulated/floor{tag = "icon-cafeteria"; icon_state = "cafeteria"},/obj/structure/extinguisher_cabinet{pixel_x = 32},/turf/simulated/floor{tag = "icon-siding2"; icon_state = "siding2"},/area/mine/unexplored)
"cC" = (/turf/simulated/floor/plating/airless/asteroid,/obj/machinery/light/spot{tag = "icon-tube1 (EAST)"; icon_state = "tube1"; dir = 4},/obj/item/weapon/cigbutt,/obj/item/weapon/cigbutt,/turf/simulated/floor/airless/uristturf,/area/mine/unexplored)
"cD" = (/obj/structure/table/rack,/turf/simulated/floor{tag = "icon-blueyellowfull"; icon_state = "blueyellowfull"},/area/mine/unexplored)
"cE" = (/obj/structure/coatrack,/turf/simulated/floor,/area/mine/unexplored)
"cF" = (/obj/machinery/media/jukebox,/turf/simulated/floor{tag = "icon-bar"; icon_state = "bar"},/area/mine/unexplored)
"cG" = (/turf/simulated/floor/plating/airless/asteroid,/mob/living/simple_animal/hostile/syndicate/ranged/space{faction = "skrellt"; name = "Skrellian terrorist"},/turf/simulated/floor/airless/uristturf,/area/mine/unexplored)
"cH" = (/turf/simulated/floor/plating/airless/asteroid,/obj/item/weapon/cigbutt,/turf/simulated/floor/airless/uristturf,/area/mine/unexplored)
"cI" = (/obj/machinery/space_heater,/obj/effect/decal/cleanable/spiderling_remains,/turf/simulated/floor{tag = "icon-bar"; icon_state = "bar"},/area/mine/unexplored)
"cJ" = (/obj/machinery/smartfridge/drinks,/turf/simulated/floor{tag = "icon-bar"; icon_state = "bar"},/area/mine/unexplored)
"cK" = (/turf/simulated/wall/r_wall,/obj/item/ammo_casing/a12mm,/obj/item/ammo_casing/a12mm,/obj/item/ammo_casing/a12mm,/obj/item/ammo_casing/a12mm,/turf/simulated/floor/airless/uristturf,/area/mine/unexplored)
"cL" = (/turf/simulated/floor/plating/airless/asteroid,/obj/item/ammo_casing/a12mm,/obj/item/ammo_casing/a12mm,/obj/item/ammo_casing/a12mm,/obj/item/ammo_casing/a12mm,/obj/item/ammo_casing/a12mm,/mob/living/simple_animal/hostile/syndicate/ranged/space{faction = "skrellt"; name = "Skrellian terrorist"},/turf/simulated/floor/airless/uristturf,/area/mine/unexplored)
"cM" = (/turf/simulated/wall/r_wall,/obj/item/target,/turf/simulated/floor/airless/uristturf,/area/mine/unexplored)

(1,1,1) = {"
aaabacabacabacabacababababababadabababab
abaeafagahaiahajakaeaealamanabaoaoaoaoab
acapaqarasasasaratauaeavawaxabayayazaoab
abaAaqaBaCaDaEaFataGaeaHaIaJababababadab
acaKaqaLaMaNaOaFataPaQaRaRaRabaSaTaUaVab
abaWaqaBaXaYaZaFataPbaaRaRaRadaVaVaVbbab
acaKaqarasasasaratbcaebdbebeadaVbfbfaVab
abaebgbhbibjbibkblaeaebmbnboabbpbqbrbsab
abaeaeaeaeaeaeaeaeaebtbubvbwabababababab
abbxbybzbAaebBbubububububCbwbDbEbFbGbHab
abaeaebIbJaebKbubububububCbLbMbNbNbObPab
abbQbRbSbTbybububububububUbVbNbNbNbNbWab
abaeaebXbYaebKbubububububZcabNcbbNcccdab
abcebybzcfaecgbubububububZchbNbNbNbNciab
abababababababababbKbububUcjbNbNbNbNckab
clcmcnabcocpcpcqabcrbububCcsctbNbNbNcuab
clcvcmadcwcwcxcwadbubububCbwcscyczcAcBab
clcmcCabcDcDcDcDabcEbububCbwbwcscsbwcFab
clcGcHababababababababababcIbwbwbwbwcJab
aaaaaacKcLcmcmcmaaaaaacMabababababababab
"}
