"a" = (/turf/space,/area/space)
"b" = (/turf/simulated/mineral,/area/space)
"c" = (/turf/simulated/mineral/random,/area/space)
"d" = (/turf/simulated/mineral/random/high_chance,/area/space)

(1,1,1) = {"
aaaaaaaaaaaaaaaa
aaaaabaaaaaaaaaa
aaaabbbbaaaaaaaa
aaccbbbaaaaaaaaa
aaacccbaaaaaaaaa
aaaaccaaaabbbaaa
aaaaaaaabcccaaaa
aaaaaaaaaccccaaa
aaaabbaaacccbaaa
aabbbbbbaaccbaaa
abbbcdbaaacbaaaa
abbcccbbaaaaaaaa
bbccccbbaaaaaaaa
abbcccbaaaaaaaaa
aabbbbbaaaaaaaaa
aaabbabaaaaaaaaa
"}
