"a" = (/turf/space,/area/space)
"b" = (/turf/simulated/mineral/random,/area/space)
"c" = (/turf/simulated/floor/asteroid,/area/space)
"d" = (/turf/simulated/wall/uranium,/area/space)
"e" = (/obj/machinery/door/unpowered/shuttle,/turf/simulated/floor/airless,/area/space)
"f" = (/turf/simulated/floor/asteroid,/turf/simulated/shuttle/wall{icon_state = "swall_f9"; dir = 2},/area/space)
"g" = (/obj/landmark/corpse/clown,/turf/simulated/floor/airless,/area/space)
"h" = (/turf/simulated/floor/airless,/area/space)
"i" = (/obj/structure/closet/crate,/turf/simulated/floor/airless,/area/space)
"j" = (/obj/structure/closet/crate{icon_state = "crateopen"; opened = 1},/turf/simulated/floor/airless,/area/space)
"k" = (/obj/structure/shuttle/engine/heater{icon_state = "heater"; dir = 4},/obj/structure/window/reinforced{dir = 8},/turf/simulated/floor/plating/airless,/area/space)
"l" = (/obj/structure/shuttle/engine/propulsion{icon_state = "propulsion_l"; dir = 8},/obj/structure/shuttle/engine/propulsion{icon_state = "burst_r"; dir = 8},/turf/space,/area/space)
"m" = (/obj/item/material/shard{icon_state = "small"},/turf/simulated/floor/asteroid,/area/space)
"n" = (/obj/structure/shuttle/engine/propulsion{icon_state = "propulsion_l"; dir = 8},/turf/space,/area/space)
"o" = (/obj/item/material/shard{icon_state = "medium"},/obj/structure/bed/chair{dir = 8},/turf/simulated/floor/asteroid,/area/space)
"p" = (/obj/landmark/corpse/clown{name = "Clown Pilot"},/turf/simulated/floor/airless,/area/space)
"q" = (/obj/item/paper{info = "The call has gone out! Our ancestral home has been rediscovered! Not a small patch of land, but a true clown nation, a true Clown Planet! We're on our way home at last!"},/turf/simulated/floor/airless,/area/space)
"r" = (/obj/structure/grille,/obj/structure/window/reinforced,/obj/structure/window/reinforced{dir = 8},/obj/structure/window/reinforced{dir = 4},/turf/simulated/floor/plating/airless,/area/space)
"s" = (/obj/item/material/shard,/obj/structure/bed/chair{dir = 8},/turf/simulated/floor/airless,/area/space)
"t" = (/turf/space,/turf/simulated/shuttle/wall{icon_state = "swall_f5"; dir = 2},/area/space)
"u" = (/turf/simulated/floor/airless,/turf/simulated/shuttle/wall{icon_state = "swall_f10"; dir = 2},/area/space)
"v" = (/obj/item/pickaxe,/turf/simulated/floor/airless,/area/space)
"w" = (/obj/structure/shuttle/engine/propulsion{icon_state = "propulsion_l"; dir = 8},/obj/structure/shuttle/engine/propulsion{icon_state = "propulsion_l"; dir = 8},/turf/space,/area/space)

(1,1,1) = {"
abbaaaaccccccaaaaaaaaaaaaaaa
bbbbaabbbbbccbbbaaaaaaaaaaaa
bbbbbbbbbbbccbbaaaaaaaaaaaaa
abbbbbbbbbbbbbbaaaaaaaaaaaaa
abbbbbbbbbbbbccaadddeeddddda
aabbbbbbbbbbbbcddfcghhiijhkl
aaabbbbbbbbbbbbbbbmhhhhhhhkn
aabbbbbbbbbbbbbbbophqhhhhhkn
aabbbbbbbbbbbbbrhshhhghhhhkn
aabbbbbbbbbbbbbtduhvhhiiihkw
aabbbbbbbbbbbbbbbdddeeddddda
abbbbbbbbbbbbbbbbbbbbbbbbaaa
abbabbbbbccbbbbbbbbbbbaaaaaa
aaaabbbbcccbbbbbbbbbaaaaaaaa
aaaabbaaaaccbcbbcccaaaaaaaaa
aaaabaaaaaacbbbbbbcaaaaaaaaa
aaaaaaaaaaaaaabbbbcaaaaaaaaa
"}
