"a" = (/turf/space,/area/space)
"b" = (/obj/item/weapon/material/shard{icon_state = "medium"},/turf/space,/area/space)
"c" = (/turf/simulated/shuttle/wall{icon_state = "swall_s6"; dir = 2},/area/space)
"d" = (/turf/simulated/shuttle/wall{icon_state = "swall12"; dir = 2},/area/space)
"e" = (/obj/structure/grille,/obj/structure/window/reinforced,/obj/structure/window/reinforced{dir = 8},/turf/simulated/floor/plating/airless,/area/space)
"f" = (/obj/item/stack/rods,/obj/item/weapon/material/shard,/turf/simulated/floor/plating/airless,/area/space)
"g" = (/obj/item/stack/tile/steel,/turf/space,/area/space)
"h" = (/turf/simulated/floor/plating/airless,/area/space)
"i" = (/turf/simulated/shuttle/wall{icon_state = "swall11"; dir = 2},/area/space)
"j" = (/obj/structure/table/standard,/obj/item/weapon/storage/toolbox/mechanical,/turf/simulated/floor/airless/ceiling{icon = 'icons/turf/shuttle.dmi'; icon_state = "floor"; tag = "icon-asteroid"},/area/space)
"k" = (/turf/simulated/floor/airless/ceiling{icon = 'icons/turf/shuttle.dmi'; icon_state = "floor"; tag = "icon-asteroid"},/area/space)
"l" = (/obj/item/weapon/material/shard{icon_state = "small"},/turf/simulated/floor/plating/airless,/area/space)
"m" = (/turf/simulated/shuttle/wall{icon_state = "swall3"; dir = 2},/area/space)
"n" = (/obj/structure/bed/chair/urist/shuttle{tag = "icon-shuttlechair (WEST)"; icon_state = "shuttlechair"; dir = 8},/turf/simulated/floor/airless/ceiling{icon = 'icons/turf/shuttle.dmi'; icon_state = "floor"; tag = "icon-asteroid"},/area/space)
"o" = (/obj/item/stack/tile/steel,/turf/simulated/floor/plating/airless,/area/space)
"p" = (/obj/structure/shuttle/engine/heater{icon_state = "heater"; dir = 4},/obj/structure/window/reinforced{dir = 8},/turf/simulated/floor/plating/airless,/area/space)
"q" = (/obj/structure/grille,/obj/structure/window/reinforced,/obj/structure/window/reinforced{dir = 4},/turf/simulated/shuttle/plating,/area/space)
"r" = (/obj/item/stack/material/glass{amount = 17},/turf/simulated/floor/plating/airless,/area/space)
"s" = (/obj/machinery/door/unpowered/shuttle,/turf/simulated/floor/airless/ceiling{icon = 'icons/turf/shuttle.dmi'; icon_state = "floor"; tag = "icon-asteroid"},/area/space)
"t" = (/obj/item/stack/material/steel{amount = 23},/turf/simulated/floor/plating/airless,/area/space)
"u" = (/obj/structure/shuttle/engine/propulsion{icon_state = "propulsion"; dir = 8},/turf/space,/area/space)
"v" = (/turf/simulated/shuttle/wall{icon_state = "swall7"; dir = 2},/area/space)
"w" = (/turf/simulated/shuttle/wall{dir = 1; icon_state = "swall_floor_f10"},/area/space)
"x" = (/obj/item/stack/cable_coil,/turf/simulated/floor/airless/ceiling{icon = 'icons/turf/shuttle.dmi'; icon_state = "floor"; tag = "icon-asteroid"},/area/space)
"y" = (/turf/simulated/shuttle/wall{icon_state = "swall_s5"; dir = 2},/area/space)
"z" = (/turf/simulated/shuttle/wall{icon_state = "swall13"; dir = 2},/area/space)
"A" = (/obj/structure/table/standard,/obj/item/weapon/storage/firstaid/regular{pixel_x = 2; pixel_y = 3},/turf/simulated/floor/airless/ceiling{icon = 'icons/turf/shuttle.dmi'; icon_state = "floor"; tag = "icon-asteroid"},/area/space)
"B" = (/obj/item/weapon/material/shard{icon_state = "medium"},/turf/simulated/floor/airless/ceiling{icon = 'icons/turf/shuttle.dmi'; icon_state = "floor"; tag = "icon-asteroid"},/area/space)
"C" = (/obj/structure/shuttle/engine/propulsion{icon_state = "burst_l"; dir = 8},/turf/space,/area/space)
"D" = (/obj/structure/grille,/obj/item/weapon/material/shard{icon_state = "small"},/turf/simulated/floor/plating/airless,/area/space)
"E" = (/obj/structure/grille,/obj/structure/window/reinforced,/turf/simulated/floor/plating/airless,/area/space)
"F" = (/obj/structure/grille,/obj/structure/window/reinforced,/obj/structure/window/reinforced{dir = 8},/obj/structure/window/reinforced{dir = 1},/turf/simulated/floor/plating/airless,/area/space)

(1,1,1) = {"
aaaaaaaaaabaaa
aaaacdddefaaaa
gahdijkkklahha
aaahmknhhhohpa
qhroskkkokhtpu
vwknmknxknhkpu
yzddiAkkkkkBvC
aaaaydDEhhFEza
"}
