"a" = (/turf/space,/area/space)
"b" = (/obj/item/material/shard{icon_state = "medium"},/turf/space,/area/space)
"c" = (/turf/space,/turf/simulated/shuttle/wall{icon_state = "corner_white"; dir = 4},/area/space)
"d" = (/turf/simulated/shuttle/wall{icon_state = "swall_straight"; dir = 4},/area/space)
"e" = (/obj/structure/grille,/obj/structure/window/reinforced,/obj/structure/window/reinforced{dir = 8},/turf/simulated/floor/plating/airless,/area/space)
"f" = (/obj/item/stack/rods,/obj/item/material/shard,/turf/simulated/floor/plating/airless,/area/space)
"g" = (/obj/item/stack/tile/floor,/turf/space,/area/space)
"h" = (/turf/simulated/floor/plating/airless,/area/space)
"i" = (/turf/simulated/shuttle/wall{icon_state = "swall_t"; dir = 4},/area/space)
"j" = (/obj/structure/table/standard,/obj/item/storage/toolbox/mechanical,/turf/simulated/floor/airless/ceiling{icon = 'icons/turf/shuttle.dmi'; icon_state = "floor"},/area/space)
"k" = (/turf/simulated/floor/airless/ceiling{icon = 'icons/turf/shuttle.dmi'; icon_state = "floor"},/area/space)
"l" = (/obj/item/material/shard{icon_state = "small"},/turf/simulated/floor/plating/airless,/area/space)
"m" = (/turf/simulated/shuttle/wall{icon_state = "swall_straight"},/area/space)
"n" = (/obj/structure/bed/chair/urist/shuttle{icon_state = "shuttlechair"; dir = 8},/turf/simulated/floor/airless/ceiling{icon = 'icons/turf/shuttle.dmi'; icon_state = "floor"},/area/space)
"o" = (/obj/item/stack/tile/floor,/turf/simulated/floor/plating/airless,/area/space)
"p" = (/obj/structure/shuttle/engine/heater{icon_state = "heater"; dir = 4},/obj/structure/window/reinforced{dir = 8},/turf/simulated/floor/plating/airless,/area/space)
"q" = (/obj/structure/grille,/obj/structure/window/reinforced,/obj/structure/window/reinforced{dir = 4},/turf/simulated/shuttle/plating,/area/space)
"r" = (/obj/item/stack/material/glass{amount = 17},/turf/simulated/floor/plating/airless,/area/space)
"s" = (/obj/machinery/door/unpowered/shuttle,/turf/simulated/floor/airless/ceiling{icon = 'icons/turf/shuttle.dmi'; icon_state = "floor"},/area/space)
"t" = (/obj/item/stack/material/steel{amount = 23},/turf/simulated/floor/plating/airless,/area/space)
"u" = (/obj/structure/shuttle/engine/propulsion{icon_state = "propulsion"; dir = 8},/turf/space,/area/space)
"v" = (/turf/simulated/floor/shuttle/blue,/area/space)
"w" = (/obj/item/stack/cable_coil,/turf/simulated/floor/airless/ceiling{icon = 'icons/turf/shuttle.dmi'; icon_state = "floor"},/area/space)
"x" = (/turf/space,/turf/simulated/shuttle/wall{icon_state = "corner_white"; dir = 1},/area/space)
"y" = (/obj/structure/table/standard,/obj/item/storage/firstaid/regular{pixel_x = 2; pixel_y = 3},/turf/simulated/floor/airless/ceiling{icon = 'icons/turf/shuttle.dmi'; icon_state = "floor"},/area/space)
"z" = (/obj/item/material/shard{icon_state = "medium"},/turf/simulated/floor/airless/ceiling{icon = 'icons/turf/shuttle.dmi'; icon_state = "floor"},/area/space)
"A" = (/obj/structure/shuttle/engine/propulsion{icon_state = "burst_l"; dir = 8},/turf/space,/area/space)
"B" = (/obj/structure/grille,/obj/item/material/shard{icon_state = "small"},/turf/simulated/floor/plating/airless,/area/space)
"C" = (/obj/structure/grille,/obj/structure/window/reinforced,/turf/simulated/floor/plating/airless,/area/space)
"D" = (/obj/structure/grille,/obj/structure/window/reinforced,/obj/structure/window/reinforced{dir = 8},/obj/structure/window/reinforced{dir = 1},/turf/simulated/floor/plating/airless,/area/space)
"E" = (/turf/space,/turf/simulated/shuttle/wall{icon_state = "swall_c"; dir = 8},/area/space)

(1,1,1) = {"
aaaaaaaaaabaaa
aaaacdddefaaaa
gahdijkkklahha
aaahmknhhhohpa
qhroskkkokhtpu
mvknmknwknhkpu
xdddiykkkkkzhA
aaaaxdBChhDCdE
"}
