"ab" = (/turf/simulated/wall/r_wall,/area/mine/unexplored)
"ac" = (/obj/structure/window/reinforced,/obj/structure/window/reinforced{dir = 8},/obj/structure/window/reinforced{dir = 4},/obj/structure/window/reinforced{icon_state = "rwindow"; dir = 1},/obj/structure/grille,/turf/simulated/floor,/area/mine/unexplored)
"ad" = (/obj/machinery/door/airlock/highsecurity,/turf/simulated/floor,/area/mine/unexplored)
"ae" = (/turf/simulated/wall,/area/mine/unexplored)
"af" = (/obj/structure/bed/padded,/obj/item/bedsheet/urist/syndie,/turf/simulated/floor/wood,/area/mine/unexplored)
"ag" = (/obj/structure/closet,/obj/machinery/light/small{active_power_usage = 0; dir = 1; icon_state = "bulb1"; on = 1; use_power = 0},/obj/item/clothing/accessory/storage/knifeharness,/obj/item/device/measuring_tape,/turf/simulated/floor/wood,/area/mine/unexplored)
"ah" = (/obj/structure/closet,/obj/machinery/light/small{active_power_usage = 0; dir = 1; icon_state = "bulb1"; on = 1; use_power = 0},/obj/item/storage/briefcase,/turf/simulated/floor/wood,/area/mine/unexplored)
"ai" = (/obj/structure/closet,/obj/machinery/light/small{active_power_usage = 0; dir = 1; icon_state = "bulb1"; on = 1; use_power = 0},/obj/random/contraband,/obj/random/contraband,/turf/simulated/floor/wood,/area/mine/unexplored)
"aj" = (/obj/structure/bed/padded,/obj/item/bedsheet/urist/syndie,/obj/random/plushie,/turf/simulated/floor/wood,/area/mine/unexplored)
"ak" = (/obj/structure/bookcase/manuals/medical,/turf/simulated/floor/wood,/area/mine/unexplored)
"al" = (/obj/machinery/light/small{active_power_usage = 0; dir = 1; icon_state = "bulb1"; on = 1; use_power = 0},/obj/structure/bookcase,/turf/simulated/floor/wood,/area/mine/unexplored)
"am" = (/obj/structure/bookcase,/turf/simulated/floor/wood,/area/mine/unexplored)
"an" = (/turf/simulated/floor/tiled/dark,/area/mine/unexplored)
"ao" = (/obj/machinery/light/small{active_power_usage = 0; dir = 1; icon_state = "bulb1"; on = 1; use_power = 0},/turf/simulated/floor/tiled/dark,/area/mine/unexplored)
"ap" = (/obj/structure/bed/padded,/obj/item/bedsheet/urist/syndie,/mob/living/simple_animal/hostile/urist/skrellterrorist,/turf/simulated/floor/wood,/area/mine/unexplored)
"aq" = (/turf/simulated/floor/wood,/area/mine/unexplored)
"ar" = (/obj/structure/undies_wardrobe,/obj/decal/cleanable/cobweb2,/turf/simulated/floor/wood,/area/mine/unexplored)
"as" = (/obj/structure/bed/chair/comfy/brown{icon_state = "comfychair_preview"; dir = 4},/obj/decal/cleanable/dirt,/mob/living/simple_animal/hostile/urist/skrellterrorist,/turf/simulated/floor/wood,/area/mine/unexplored)
"at" = (/obj/structure/table/woodentable,/obj/item/device/flashlight/lamp,/turf/simulated/floor/wood,/area/mine/unexplored)
"au" = (/obj/structure/bed/chair/comfy/brown{icon_state = "comfychair_preview"; dir = 8},/mob/living/simple_animal/hostile/urist/skrellterrorist,/turf/simulated/floor/wood,/area/mine/unexplored)
"av" = (/obj/structure/closet/emsuits,/obj/structure/closet/walllocker/emerglocker{pixel_y = -32},/obj/floor_decal/industrial/hatch,/turf/simulated/floor/tiled/dark,/area/mine/unexplored)
"aw" = (/obj/structure/dispenser,/obj/floor_decal/industrial/hatch,/turf/simulated/floor/tiled/dark,/area/mine/unexplored)
"ax" = (/obj/structure/closet,/obj/random/contraband,/obj/item/cane,/turf/simulated/floor/wood,/area/mine/unexplored)
"ay" = (/obj/structure/bed/chair/wood{icon_state = "wooden_chair"; dir = 4},/obj/floor_decal/spline/fancy/wood{icon_state = "spline_fancy"; dir = 9},/turf/simulated/floor/tiled/dark,/area/mine/unexplored)
"az" = (/obj/structure/table/woodentable,/obj/floor_decal/spline/fancy/wood{dir = 1},/turf/simulated/floor/tiled/dark,/area/mine/unexplored)
"aA" = (/obj/structure/table/woodentable,/obj/random/contraband,/obj/floor_decal/spline/fancy/wood{dir = 1},/turf/simulated/floor/tiled/dark,/area/mine/unexplored)
"aB" = (/obj/structure/table/woodentable,/obj/item/dice,/obj/item/material/folder,/obj/floor_decal/spline/fancy/wood{dir = 1},/turf/simulated/floor/tiled/dark,/area/mine/unexplored)
"aC" = (/obj/structure/bed/chair/wood{icon_state = "wooden_chair"; dir = 8},/obj/floor_decal/spline/fancy/wood{dir = 5},/turf/simulated/floor/tiled/dark,/area/mine/unexplored)
"aD" = (/obj/machinery/space_heater,/obj/structure/extinguisher_cabinet{pixel_x = 32},/turf/simulated/floor/wood,/area/mine/unexplored)
"aE" = (/obj/structure/bed/chair/comfy/brown{icon_state = "comfychair_preview"; dir = 4},/turf/simulated/floor/wood,/area/mine/unexplored)
"aF" = (/obj/structure/table/woodentable,/obj/item/newspaper,/turf/simulated/floor/wood,/area/mine/unexplored)
"aG" = (/obj/structure/bed/chair/comfy/brown{icon_state = "comfychair_preview"; dir = 8},/turf/simulated/floor/wood,/area/mine/unexplored)
"aH" = (/obj/machinery/door/airlock/highsecurity,/turf/simulated/floor/tiled/dark,/area/mine/unexplored)
"aI" = (/obj/structure/bed/chair/wood{icon_state = "wooden_chair"; dir = 4},/obj/item/clothing/mask/smokable/cigarette/cigar,/obj/floor_decal/spline/fancy/wood{dir = 8},/turf/simulated/floor/tiled/dark,/area/mine/unexplored)
"aJ" = (/obj/structure/table/woodentable,/obj/item/device/radio/off,/turf/simulated/floor/tiled/dark,/area/mine/unexplored)
"aK" = (/obj/structure/cult/pylon,/obj/item/ectoplasm,/turf/simulated/floor/tiled/dark,/area/mine/unexplored)
"aL" = (/obj/structure/table/woodentable,/obj/item/device/flashlight/lamp,/turf/simulated/floor/tiled/dark,/area/mine/unexplored)
"aM" = (/obj/structure/bed/chair/wood{icon_state = "wooden_chair"; dir = 8},/obj/floor_decal/spline/fancy/wood{icon_state = "spline_fancy"; dir = 4},/turf/simulated/floor/tiled/dark,/area/mine/unexplored)
"aN" = (/obj/machinery/door/unpowered/simple/wood,/turf/simulated/floor/wood,/area/mine/unexplored)
"aO" = (/obj/structure/closet/secure_closet/guncabinet,/obj/random/projectile,/obj/random/projectile,/obj/random/projectile,/obj/item/gun/projectile/automatic/c20r,/turf/simulated/floor/reinforced,/area/mine/unexplored)
"aP" = (/obj/structure/closet/secure_closet/guncabinet,/obj/random/projectile,/obj/random/handgun,/turf/simulated/floor/reinforced,/area/mine/unexplored)
"aQ" = (/obj/structure/closet/secure_closet/guncabinet,/obj/random/projectile,/turf/simulated/floor/reinforced,/area/mine/unexplored)
"aR" = (/turf/simulated/floor/reinforced,/area/mine/unexplored)
"aS" = (/obj/structure/closet,/obj/random/action_figure,/obj/random/bomb_supply,/turf/simulated/floor/wood,/area/mine/unexplored)
"aT" = (/obj/structure/bed/chair/wood{icon_state = "wooden_chair"; dir = 4},/obj/floor_decal/spline/fancy/wood{icon_state = "spline_fancy"; dir = 10},/turf/simulated/floor/tiled/dark,/area/mine/unexplored)
"aU" = (/obj/structure/table/woodentable,/obj/item/reagent_containers/food/snacks/skrellsnacks,/obj/floor_decal/spline/fancy/wood,/turf/simulated/floor/tiled/dark,/area/mine/unexplored)
"aV" = (/obj/structure/table/woodentable,/obj/item/gag/BANG{desc = "When you absolutely, positively need a 10mm hole in the other guy. Uses .357 ammo."; name = "mateba"},/obj/floor_decal/spline/fancy/wood,/turf/simulated/floor/tiled/dark,/area/mine/unexplored)
"aW" = (/obj/structure/table/woodentable,/obj/item/reagent_containers/food/drinks/coffee,/obj/floor_decal/spline/fancy/wood,/turf/simulated/floor/tiled/dark,/area/mine/unexplored)
"aX" = (/obj/structure/bed/chair/wood{icon_state = "wooden_chair"; dir = 8},/obj/floor_decal/spline/fancy/wood{dir = 6},/turf/simulated/floor/tiled/dark,/area/mine/unexplored)
"aY" = (/obj/structure/extinguisher_cabinet{pixel_x = 32},/turf/simulated/floor/reinforced,/area/mine/unexplored)
"aZ" = (/obj/structure/closet/wardrobe/pjs,/turf/simulated/floor/wood,/area/mine/unexplored)
"ba" = (/obj/structure/noticeboard{pixel_x = -32},/obj/floor_decal/spline/fancy/wood,/turf/simulated/floor/wood,/area/mine/unexplored)
"bb" = (/obj/floor_decal/spline/fancy/wood,/turf/simulated/floor/wood,/area/mine/unexplored)
"bc" = (/mob/living/simple_animal/hostile/urist/skrellterrorist,/turf/simulated/floor/reinforced,/area/mine/unexplored)
"bd" = (/obj/structure/bed/padded,/obj/item/bedsheet/urist/syndie,/obj/structure/closet/walllocker/emerglocker{pixel_y = -32},/turf/simulated/floor/wood,/area/mine/unexplored)
"be" = (/obj/structure/closet,/obj/random/toolbox,/obj/machinery/light/small{active_power_usage = 0; idle_power_usage = 0; on = 1; use_power = 0},/turf/simulated/floor/wood,/area/mine/unexplored)
"bf" = (/obj/structure/closet,/obj/item/gun/projectile/automatic/c20r,/obj/machinery/light/small{active_power_usage = 0; idle_power_usage = 0; on = 1; use_power = 0},/turf/simulated/floor/wood,/area/mine/unexplored)
"bg" = (/obj/structure/closet,/obj/machinery/light/small{active_power_usage = 0; idle_power_usage = 0; on = 1; use_power = 0},/obj/item/clothing/mask/balaclava,/turf/simulated/floor/wood,/area/mine/unexplored)
"bh" = (/obj/structure/bed/padded,/obj/item/bedsheet/urist/syndie,/obj/structure/closet/walllocker/emerglocker{pixel_y = -32},/mob/living/simple_animal/hostile/urist/skrellterrorist,/turf/simulated/floor/wood,/area/mine/unexplored)
"bi" = (/obj/structure/window/reinforced{icon_state = "rwindow"; dir = 1},/obj/structure/window/reinforced{dir = 4},/obj/floor_decal/corner/paleblue/diagonal,/turf/simulated/floor/tiled/white,/area/mine/unexplored)
"bj" = (/obj/floor_decal/corner/paleblue{dir = 10},/turf/simulated/floor/wood,/area/mine/unexplored)
"bk" = (/obj/structure/sign/warning/secure_area{pixel_x = 28},/obj/structure/window/reinforced{icon_state = "rwindow"; dir = 1},/obj/structure/window/reinforced{dir = 8},/obj/floor_decal/corner/paleblue/diagonal,/turf/simulated/floor/tiled/white,/area/mine/unexplored)
"bl" = (/obj/structure/closet/syndicate/suit,/obj/machinery/light/small{active_power_usage = 0; idle_power_usage = 0; on = 1; use_power = 0},/turf/simulated/floor/reinforced,/area/mine/unexplored)
"bm" = (/obj/structure/closet/syndicate,/obj/random/firstaid,/obj/item/reagent_containers/glass/beaker/vial/random/toxin,/turf/simulated/floor/reinforced,/area/mine/unexplored)
"bn" = (/obj/structure/closet/syndicate,/obj/random/ammo,/obj/random/ammo,/obj/item/grenade/chem_grenade/teargas,/turf/simulated/floor/reinforced,/area/mine/unexplored)
"bo" = (/obj/structure/safe,/obj/item/storage/bag/cash,/obj/item/vampiric,/obj/item/archaeological_find,/turf/simulated/floor/reinforced,/area/mine/unexplored)
"bp" = (/obj/structure/reagent_dispensers/water_cooler,/turf/simulated/floor,/area/mine/unexplored)
"br" = (/obj/structure/hygiene/toilet{icon_state = "toilet00"; dir = 4},/turf/simulated/floor/tiled/dark,/area/mine/unexplored)
"bs" = (/obj/machinery/door/unpowered/simple/wood,/turf/simulated/floor/tiled/dark,/area/mine/unexplored)
"bt" = (/obj/structure/closet/medical_wall{pixel_y = 32},/obj/structure/hygiene/sink{dir = 4; icon_state = "sink"; pixel_x = 8},/obj/item/storage/mirror{pixel_x = 28},/turf/simulated/floor/tiled/dark,/area/mine/unexplored)
"bu" = (/obj/structure/bedsheetbin,/obj/structure/table/standard,/turf/simulated/floor/tiled/dark,/area/mine/unexplored)
"bv" = (/obj/floor_decal/spline/fancy{icon_state = "spline_fancy"; dir = 4},/turf/simulated/floor/tiled/dark,/area/mine/unexplored)
"bw" = (/obj/item/stool,/obj/machinery/light{icon_state = "tube1"; dir = 1},/obj/floor_decal/spline/fancy{icon_state = "spline_fancy"; dir = 1},/obj/floor_decal/corner/paleblue/diagonal,/turf/simulated/floor/tiled/white,/area/mine/unexplored)
"bx" = (/obj/structure/table/standard,/obj/item/reagent_containers/food/drinks/bottle/small/ale,/obj/item/trash/bowl,/obj/floor_decal/spline/fancy{icon_state = "spline_fancy"; dir = 1},/obj/floor_decal/spline/fancy{icon_state = "spline_fancy"; dir = 8},/turf/simulated/floor/tiled/freezer,/area/mine/unexplored)
"by" = (/obj/structure/table/standard,/obj/item/tray,/obj/floor_decal/spline/fancy{icon_state = "spline_fancy"; dir = 1},/turf/simulated/floor/tiled/freezer,/area/mine/unexplored)
"bz" = (/obj/floor_decal/spline/fancy{icon_state = "spline_fancy"; dir = 1},/turf/simulated/floor/tiled/freezer,/area/mine/unexplored)
"bA" = (/obj/structure/kitchenspike,/obj/floor_decal/spline/fancy{icon_state = "spline_fancy"; dir = 1},/turf/simulated/floor/tiled/freezer,/area/mine/unexplored)
"bB" = (/obj/machinery/light{dir = 4; icon_state = "tube1"},/turf/simulated/floor/tiled/dark,/area/mine/unexplored)
"bC" = (/obj/machinery/light{active_power_usage = 0; dir = 8; icon_state = "tube1"; on = 1; use_power = 0},/turf/simulated/floor/tiled/dark,/area/mine/unexplored)
"bD" = (/obj/item/stool,/obj/item/trash/cigbutt,/obj/floor_decal/corner/paleblue/diagonal,/turf/simulated/floor/tiled/white,/area/mine/unexplored)
"bE" = (/obj/structure/table/standard,/obj/item/reagent_containers/food/drinks/bottle/vodka,/obj/floor_decal/spline/fancy{icon_state = "spline_fancy"; dir = 9},/turf/simulated/floor/tiled/freezer,/area/mine/unexplored)
"bF" = (/turf/simulated/floor/tiled/freezer,/area/mine/unexplored)
"bG" = (/obj/decal/cleanable/flour,/turf/simulated/floor/tiled/freezer,/area/mine/unexplored)
"bH" = (/obj/machinery/light{icon_state = "tube1"; dir = 4},/obj/machinery/cooker/grill,/obj/decal/cleanable/ash,/turf/simulated/floor/tiled/freezer,/area/mine/unexplored)
"bI" = (/obj/item/soap/red_soap,/turf/simulated/floor/tiled/dark,/area/mine/unexplored)
"bJ" = (/obj/structure/curtain/open/shower,/turf/simulated/floor/tiled/dark,/area/mine/unexplored)
"bK" = (/obj/item/stool,/obj/floor_decal/corner/paleblue/diagonal,/mob/living/simple_animal/hostile/urist/skrellterrorist,/turf/simulated/floor/tiled/white,/area/mine/unexplored)
"bL" = (/obj/structure/table/standard,/obj/item/reagent_containers/food/snacks/ricepudding,/obj/item/material/kitchen/utensil/spoon/plastic,/obj/floor_decal/spline/fancy{icon_state = "spline_fancy"; dir = 9},/turf/simulated/floor/tiled/freezer,/area/mine/unexplored)
"bM" = (/obj/structure/closet/fridge,/turf/simulated/floor/tiled/freezer,/area/mine/unexplored)
"bN" = (/obj/item/stool,/obj/floor_decal/corner/paleblue/diagonal,/turf/simulated/floor/tiled/white,/area/mine/unexplored)
"bO" = (/obj/structure/table/standard,/obj/item/reagent_containers/food/snacks/fries,/obj/floor_decal/spline/fancy{icon_state = "spline_fancy"; dir = 8},/turf/simulated/floor/tiled/freezer,/area/mine/unexplored)
"bP" = (/mob/living/simple_animal/hostile/urist/skrellterrorist,/turf/simulated/floor/tiled/freezer,/area/mine/unexplored)
"bQ" = (/obj/decal/cleanable/fruit_smudge,/turf/simulated/floor/tiled/freezer,/area/mine/unexplored)
"bR" = (/obj/structure/table/standard,/obj/machinery/microwave,/turf/simulated/floor/tiled/freezer,/area/mine/unexplored)
"bS" = (/obj/structure/hygiene/toilet{icon_state = "toilet00"; dir = 4},/obj/decal/cleanable/vomit,/mob/living/simple_animal/hostile/urist/skrellterrorist,/turf/simulated/floor/tiled/dark,/area/mine/unexplored)
"bT" = (/obj/structure/hygiene/sink{dir = 4; icon_state = "sink"; pixel_x = 8},/obj/item/storage/mirror{pixel_x = 28},/turf/simulated/floor/tiled/dark,/area/mine/unexplored)
"bU" = (/obj/machinery/space_heater,/turf/simulated/floor/tiled/dark,/area/mine/unexplored)
"bV" = (/obj/structure/table/standard,/obj/item/reagent_containers/food/snacks/jelliedtoast,/obj/floor_decal/spline/fancy{icon_state = "spline_fancy"; dir = 8},/turf/simulated/floor/tiled/freezer,/area/mine/unexplored)
"bW" = (/obj/structure/table/standard,/obj/item/reagent_containers/food/snacks/liquidfood,/obj/item/reagent_containers/food/snacks/liquidfood,/obj/item/reagent_containers/food/snacks/liquidfood,/obj/item/material/rollingpin,/obj/item/material/knife,/obj/decal/cleanable/flour,/turf/simulated/floor/tiled/freezer,/area/mine/unexplored)
"bX" = (/obj/floor_decal/corner/paleblue/diagonal,/obj/machinery/light{active_power_usage = 0; dir = 8; icon_state = "tube1"; on = 1; use_power = 0},/turf/simulated/floor/tiled/white,/area/mine/unexplored)
"bY" = (/obj/structure/table/standard,/obj/item/reagent_containers/food/snacks/vegetablesoup,/obj/item/material/kitchen/utensil/spoon/plastic,/obj/floor_decal/spline/fancy{icon_state = "spline_fancy"; dir = 10},/turf/simulated/floor/tiled/freezer,/area/mine/unexplored)
"bZ" = (/obj/machinery/cooker/fryer,/obj/machinery/light{icon_state = "tube1"; dir = 4},/turf/simulated/floor/tiled/freezer,/area/mine/unexplored)
"ca" = (/obj/machinery/light/spot{active_power_usage = 0; dir = 4; icon_state = "tube1"; idle_power_usage = 0; on = 1; use_power = 0},/obj/machinery/floodlight,/turf/simulated/floor/asteroid,/area/mine/unexplored)
"cb" = (/obj/decal/cleanable/dirt,/obj/structure/table/rack,/turf/simulated/floor/tiled/dark,/area/mine/unexplored)
"cc" = (/obj/machinery/light{dir = 1; icon_state = "tube1"; on = 1; use_power = 0},/obj/structure/table/rack,/turf/simulated/floor/tiled/dark,/area/mine/unexplored)
"cd" = (/obj/structure/dispenser,/turf/simulated/floor/tiled/dark,/area/mine/unexplored)
"ce" = (/obj/item/trash/cigbutt,/obj/floor_decal/corner/paleblue/diagonal,/turf/simulated/floor/tiled/white,/area/mine/unexplored)
"cf" = (/obj/structure/table/standard,/obj/item/trash/snack_bowl,/obj/floor_decal/spline/fancy{icon_state = "spline_fancy"; dir = 10},/turf/simulated/floor/tiled/freezer,/area/mine/unexplored)
"cg" = (/obj/structure/closet/kitchen/mining,/turf/simulated/floor/tiled/freezer,/area/mine/unexplored)
"ch" = (/obj/item/reagent_containers/food/snacks/skrellsnacks,/turf/simulated/floor/asteroid,/area/mine/unexplored)
"ci" = (/mob/living/simple_animal/hostile/urist/skrellterrorist,/turf/simulated/floor/tiled/dark,/area/mine/unexplored)
"cj" = (/obj/structure/table/standard,/obj/item/reagent_containers/food/snacks/fries,/obj/floor_decal/spline/fancy{icon_state = "spline_fancy"; dir = 10},/turf/simulated/floor/tiled/freezer,/area/mine/unexplored)
"ck" = (/obj/structure/table/standard,/obj/item/reagent_containers/food/drinks/bottle/rum,/obj/floor_decal/spline/fancy,/turf/simulated/floor/tiled/freezer,/area/mine/unexplored)
"cl" = (/obj/floor_decal/spline/fancy,/turf/simulated/floor/tiled/freezer,/area/mine/unexplored)
"cm" = (/obj/structure/extinguisher_cabinet{pixel_x = 32},/obj/floor_decal/spline/fancy,/turf/simulated/floor/tiled/freezer,/area/mine/unexplored)
"cn" = (/obj/item/trash/cigbutt,/obj/item/trash/cigbutt,/obj/machinery/light/spot{active_power_usage = 0; dir = 4; icon_state = "tube1"; idle_power_usage = 0; on = 1; use_power = 0},/turf/simulated/floor/asteroid,/area/mine/unexplored)
"co" = (/obj/structure/table/rack,/turf/simulated/floor/tiled/dark,/area/mine/unexplored)
"cp" = (/obj/structure/coatrack,/obj/floor_decal/corner/paleblue/diagonal,/turf/simulated/floor/tiled/white,/area/mine/unexplored)
"cq" = (/obj/floor_decal/corner/paleblue/diagonal,/turf/simulated/floor/tiled/white,/area/mine/unexplored)
"cr" = (/mob/living/simple_animal/hostile/syndicate/ranged/space{faction = "skrellt"; name = "Skrellian terrorist"},/turf/simulated/floor/asteroid,/area/mine/unexplored)
"cs" = (/obj/item/trash/cigbutt,/obj/structure/sign/warning/secure_area{pixel_x = 32},/turf/simulated/floor/asteroid,/area/mine/unexplored)
"ct" = (/obj/machinery/space_heater,/obj/decal/cleanable/spiderling_remains,/obj/floor_decal/corner/paleblue/diagonal,/turf/simulated/floor/tiled/white,/area/mine/unexplored)
"cu" = (/obj/machinery/smartfridge/drinks,/obj/floor_decal/corner/paleblue/diagonal,/turf/simulated/floor/tiled/white,/area/mine/unexplored)
"cv" = (/obj/item/ammo_casing/pistol,/obj/item/ammo_casing/pistol,/obj/item/ammo_casing/pistol,/obj/item/ammo_casing/pistol,/turf/simulated/floor/asteroid,/area/mine/unexplored)
"cw" = (/obj/item/ammo_casing/pistol,/obj/item/ammo_casing/pistol,/obj/item/ammo_casing/pistol,/obj/item/ammo_casing/pistol,/obj/item/ammo_casing/pistol,/mob/living/simple_animal/hostile/syndicate/ranged/space{faction = "skrellt"; name = "Skrellian terrorist"},/turf/simulated/floor/asteroid,/area/mine/unexplored)
"cx" = (/turf/simulated/floor/asteroid,/area/mine/unexplored)

(1,1,1) = {"
cxabacabacabacabacababababababadabababab
abaeafagafahafaiajaeaeakalamabanananaoab
acapaqaqaqaqaqaqaqaraeasatauabavavawanab
abaxaqayazaAaBaCaqaDaeaEaFaGababababaHab
acafaqaIaJaKaLaMaqaqaNaqaqaqabaOaPaQaRab
abaSaqaTaUaVaWaXaqaqaNaqaqaqadaRaRaRaYab
acafaqaqaqaqaqaqaqaZaebabbbbadaRbcbcaRab
abaebdbebdbfbdbgbhaeaebibjbkabblbmbnboab
abaeaeaeaeaeaeaeaeaebpcqcqcqabababababab
abbrbsanbtaebuanbvcqcqcqcqcqbwbxbybzbAab
abaeaeanbBaebCanbvcqcqcqcqbDbEbFbFbGbHab
abbIbJananbsananbvcqcqcqbKbLbFbFbFbFbMab
abaeaeanbBaebCanbvcqcqcqbNbObFbPbFbQbRab
abbSbsanbTaebUanbvcqcqcqbNbVbFbFbFbFbWab
abababababababababbXcqcqbKbYbFbFbFbFbZab
cxcxcaabcbcccccdabcecqcqcqbNcfbFbFbFcgab
cxchcxadanancianaHcqcqcqcqcqbNcjckclcmab
cxcxcnabcocococoabcpcqcqcqcqcqbNbNcqcqab
cxcrcsababababababababababctcqcqcqcqcuab
cxcxcxcvcwcxcxcxcxcxcxcxabababababababab
"}
