"a" = (/turf/simulated/mineral,/area/space)
"b" = (/obj/machinery/door/unpowered/simple/iron,/turf/simulated/floor/wood,/area/space)
"c" = (/obj/machinery/teleport/hub,/turf/simulated/floor/wood,/area/space)
"d" = (/turf/simulated/floor/wood,/area/space)
"e" = (/obj/structure/coatrack,/turf/simulated/floor/wood,/area/space)
"f" = (/turf/simulated/wall/wood,/area/space)
"g" = (/obj/structure/sign/double/barsign,/turf/simulated/wall/wood,/area/space)
"h" = (/obj/machinery/door/unpowered/simple/wood/saloon,/turf/simulated/floor/wood,/area/space)
"i" = (/obj/structure/bed/chair/wood{tag = "icon-wooden_chair (EAST)"; icon_state = "wooden_chair"; dir = 4},/turf/simulated/floor/lino,/area/space)
"j" = (/obj/structure/table/woodentable,/obj/item/device/flashlight/lamp/green,/turf/simulated/floor/lino,/area/space)
"k" = (/obj/structure/bed/chair/wood{dir = 8},/obj/random/trash,/turf/simulated/floor/lino,/area/space)
"l" = (/obj/structure/bed/chair/wood{tag = "icon-wooden_chair (EAST)"; icon_state = "wooden_chair"; dir = 4},/obj/random/trash,/turf/simulated/floor/lino,/area/space)
"m" = (/obj/structure/table/woodentable,/obj/item/device/flashlight/lamp/green,/obj/item/weapon/reagent_containers/food/drinks/bottle/cognac,/turf/simulated/floor/lino,/area/space)
"n" = (/obj/structure/bed/chair/wood{dir = 8},/turf/simulated/floor/lino,/area/space)
"o" = (/turf/simulated/floor/lino,/area/space)
"p" = (/obj/machinery/door/window{dir = 8},/turf/simulated/floor/lino,/area/space)
"q" = (/obj/random/trash,/turf/simulated/floor/lino,/area/space)
"r" = (/obj/item/weapon/tank/emergency/oxygen/double,/turf/simulated/floor/lino,/area/space)
"s" = (/obj/structure/table/woodentable,/obj/item/weapon/material/ashtray/bronze,/obj/item/weapon/storage/pill_bottle/zoom,/obj/random/contraband,/obj/weathertype/fog{name = "smoke"},/turf/simulated/floor/lino,/area/space)
"t" = (/obj/structure/table/woodentable,/obj/item/weapon/folder/red,/obj/weathertype/fog{name = "smoke"},/turf/simulated/floor/lino,/area/space)
"u" = (/obj/item/weapon/stool/urist/bar,/obj/weathertype/fog{name = "smoke"},/turf/simulated/floor/lino,/area/space)
"v" = (/obj/structure/table/marble,/turf/simulated/floor/lino,/area/space)
"w" = (/obj/weathertype/fog{name = "smoke"},/turf/simulated/floor/lino,/area/space)
"x" = (/obj/machinery/vending/boozeomat,/turf/simulated/floor/lino,/area/space)
"y" = (/obj/item/weapon/stool/urist/bar,/turf/simulated/floor/lino,/area/space)
"z" = (/obj/structure/table/marble,/obj/item/weapon/reagent_containers/food/snacks/sandwich,/obj/item/weapon/reagent_containers/food/drinks/bottle/small/ale,/turf/simulated/floor/lino,/area/space)
"A" = (/obj/structure/table/steel,/obj/random/medical,/obj/item/weapon/storage/box/glasses,/turf/simulated/floor/lino,/area/space)
"B" = (/obj/structure/bed/chair/couch/left/black{tag = "icon-couchblack_left (EAST)"; icon_state = "couch_left"; dir = 4},/turf/simulated/floor/lino,/area/space)
"C" = (/obj/structure/table/woodentable,/obj/item/weapon/reagent_containers/food/drinks/bottle/absinthe,/turf/simulated/floor/lino,/area/space)
"D" = (/obj/structure/bed/chair/wood,/turf/simulated/floor/lino,/area/space)
"E" = (/obj/structure/table/marble,/obj/item/weapon/newspaper,/turf/simulated/floor/lino,/area/space)
"F" = (/obj/weathertype/fog{name = "smoke"},/mob/living/simple_animal/hostile/urist/gunman{name = "Bartender"},/turf/simulated/floor/lino,/area/space)
"G" = (/obj/structure/table/steel,/obj/item/weapon/reagent_containers/food/drinks/bottle/specialwhiskey,/turf/simulated/floor/lino,/area/space)
"H" = (/obj/structure/bed/chair/couch/right/black{tag = "icon-couchblack_right (EAST)"; icon_state = "couch_right"; dir = 4},/turf/simulated/floor/lino,/area/space)
"I" = (/obj/structure/table/woodentable,/obj/random/contraband,/obj/weathertype/fog{name = "smoke"},/obj/item/weapon/storage/fancy/cigar,/turf/simulated/floor/lino,/area/space)
"J" = (/obj/structure/table/woodentable,/obj/random/loot,/obj/weathertype/fog{name = "smoke"},/turf/simulated/floor/lino,/area/space)
"K" = (/obj/structure/table/gamblingtable,/obj/weathertype/fog{name = "smoke"},/turf/simulated/floor/lino,/area/space)
"L" = (/obj/structure/table/gamblingtable,/obj/item/weapon/deck/cards,/obj/weathertype/fog{name = "smoke"},/turf/simulated/floor/lino,/area/space)
"M" = (/obj/structure/table/gamblingtable,/obj/weathertype/fog{name = "smoke"},/obj/item/device/flashlight/lamp/green,/turf/simulated/floor/lino,/area/space)
"N" = (/obj/structure/table/marble,/obj/item/weapon/reagent_containers/food/snacks/poppypretzel,/obj/item/weapon/reagent_containers/food/drinks/bottle/small/ale,/turf/simulated/floor/lino,/area/space)
"O" = (/obj/structure/table/steel,/obj/machinery/microwave,/turf/simulated/floor/lino,/area/space)
"P" = (/obj/structure/flora/pottedplant/subterranean,/turf/simulated/floor/lino,/area/space)
"Q" = (/obj/structure/bed/chair/couch/left/black{tag = "icon-couchblack_left (NORTH)"; icon_state = "couch_left"; dir = 1},/turf/simulated/floor/lino,/area/space)
"R" = (/obj/structure/bed/chair/couch/right/black{tag = "icon-couchblack_right (NORTH)"; icon_state = "couch_right"; dir = 1},/turf/simulated/floor/lino,/area/space)
"S" = (/obj/item/weapon/storage/briefcase,/turf/simulated/floor/lino,/area/space)
"T" = (/obj/item/weapon/stool/urist/bar,/obj/random/trash,/mob/living/simple_animal/hostile/russian/ranged{faction = "syndicate"},/turf/simulated/floor/lino,/area/space)
"U" = (/obj/structure/table/gamblingtable,/obj/item/weapon/storage/pill_bottle/dice,/turf/simulated/floor/lino,/area/space)
"V" = (/obj/structure/table/marble,/obj/random/contraband,/turf/simulated/floor/lino,/area/space)
"W" = (/obj/random/trash,/obj/structure/safe/floor,/obj/weathertype/fog{name = "smoke"},/turf/simulated/floor/lino,/area/space)
"X" = (/obj/structure/table/steel,/obj/item/device/flashlight/lamp/green,/obj/item/weapon/storage/pill_bottle/happy,/turf/simulated/floor/lino,/area/space)

(1,1,1) = {"
aabaaaaaaaaaaaaaaaaa
acdefffffffffgfffffa
afhffijkflmnfoopqrfa
afoqfisnfitnfouvwxfa
afowooowoooowoyzoAfa
afBCjofoDDDoooyEFGfa
afHIJofoKLMnwouNoOfa
afPQRSfooTUnooyVWXfa
affffffffffffffffffa
aaaaaaaaaaaaaaaaaaaa
"}
