"a" = (/turf/simulated/mineral/random,/area/mine/unexplored)
"b" = (/obj/effect/decal/cleanable/dirt,/obj/effect/decal/cleanable/vomit,/turf/simulated/floor/plating/airless/asteroid,/area/mine/unexplored)
"c" = (/obj/effect/landmark/corpse/miner/rig,/obj/effect/decal/cleanable/dirt,/obj/effect/decal/cleanable/mucus,/obj/effect/decal/cleanable/blood/splatter,/turf/simulated/floor/plating/airless/asteroid,/area/mine/unexplored)
"d" = (/obj/effect/landmark/glowshroom_spawn,/obj/effect/landmark/loot_spawn/low,/obj/effect/decal/cleanable/dirt,/turf/simulated/floor/plating/airless/asteroid,/area/mine/unexplored)
"e" = (/turf/simulated/floor/plating/airless/asteroid,/area/mine/unexplored)
"f" = (/obj/effect/decal/cleanable/dirt,/turf/simulated/floor/plating/airless/asteroid,/area/mine/unexplored)
"g" = (/obj/structure/boulder,/turf/simulated/floor/plating/airless/asteroid,/area/mine/unexplored)
"h" = (/obj/effect/decal/cleanable/dirt,/obj/effect/decal/cleanable/molten_item,/obj/effect/decal/cleanable/mucus,/turf/simulated/floor/plating/airless/asteroid,/area/mine/unexplored)
"i" = (/obj/structure/boulder,/obj/effect/decal/cleanable/dirt,/turf/simulated/floor/plating/airless/asteroid,/area/mine/unexplored)
"j" = (/obj/effect/decal/cleanable/dirt,/obj/structure/boulder,/turf/simulated/floor/plating/airless/asteroid,/area/mine/unexplored)
"k" = (/obj/effect/landmark/glowshroom_spawn,/turf/simulated/floor/plating/airless/asteroid,/area/mine/unexplored)
"l" = (/obj/machinery/artifact,/turf/simulated/floor/plating/airless/asteroid,/area/mine/unexplored)
"m" = (/obj/effect/decal/cleanable/dirt,/obj/effect/decal/cleanable/mucus,/turf/simulated/floor/plating/airless/asteroid,/area/mine/unexplored)
"n" = (/obj/effect/decal/cleanable/dirt,/obj/effect/decal/cleanable/molten_item,/turf/simulated/floor/plating/airless/asteroid,/area/mine/unexplored)
"o" = (/obj/effect/landmark/glowshroom_spawn,/obj/effect/decal/cleanable/dirt,/turf/simulated/floor/plating/airless/asteroid,/area/mine/unexplored)

(1,1,1) = {"
aaaaaaaaaaaaaaa
aaabcdaaeffaaaa
aaghiaaefjjfaaa
aggaaakeealjaaa
afaafeeeeaaekaa
afafjaeeeeeegea
afffaafgaejeefa
aafaakfaaefffaa
aaffaaaakfmjaaa
aaafjjaaafjjjaa
aaaaajaaaaaanoa
aaaaafaaaaaadca
eaaaeeeaaaaaaaa
eeeeeeeeeaaaaaa
"}
